,단어명,조선일보,한겨레,세계일보,총빈도수
0,수사,428,337,638,1403
1,의혹,405,346,560,1311
3,혐의,347,229,470,1046
10,조사,249,265,512,1026
14,여성,217,204,455,876
16,폭행,210,125,525,860
11,구속,237,186,428,851
15,징역,214,150,463,827
8,재판,251,257,319,827
17,논란,198,186,429,813
9,사건,251,176,361,788
6,법원,296,233,221,750
12,사망,222,133,388,743
7,인사,289,344,85,718
21,성추행,185,152,355,692
13,화재,218,152,307,677
4,날씨,314,285,13,612
46,피해,108,145,337,590
18,압수수색,197,158,233,588
22,성폭행,172,106,295,573
31,병원,139,122,303,564
23,영장,171,117,274,562
20,검사,187,136,229,552
42,불법,111,145,283,539
19,구속영장,189,133,202,524
26,소환,164,133,224,521
62,피해자,90,159,260,509
32,발견,136,97,270,503
27,출석,160,144,192,496
41,미투,117,114,249,480
49,직원,104,102,262,468
79,교사,82,120,260,462
24,전국,171,177,104,452
57,살해,94,72,285,451
124,인천,62,241,142,445
45,교수,109,126,210,445
43,미세먼지,110,209,126,445
35,사고,124,87,234,445
40,무죄,118,100,210,428
2,속보,375,32,14,421
37,살인,123,67,223,413
51,단독,101,257,50,408
38,공개,123,96,188,407
34,댓글,130,99,169,398
30,삼성,139,166,93,398
33,안희정,135,113,149,397
112,박근혜,69,192,133,394
70,비리,87,131,166,384
61,노조,90,185,109,384
28,아이,158,80,144,382
29,판사,146,109,124,379
5,별세,302,49,24,375
87,성폭력,79,134,151,364
55,아파트,96,78,190,364
130,세월호,61,145,155,361
68,이재명,87,129,145,361
114,시민,67,166,122,355
44,선고,110,102,143,355
199,학교,46,146,162,354
182,학생,49,126,177,352
39,변호사,118,77,156,351
73,처벌,85,88,178,351
91,채용,78,114,146,338
93,거부,77,118,141,336
80,남성,82,73,177,332
67,환자,88,72,170,330
170,현장,52,93,184,329
108,국민,70,92,165,327
59,신청,93,82,147,322
50,인정,103,100,118,321
104,검거,71,46,203,320
174,유치원,51,114,155,320
52,최고,100,133,84,317
75,사회,83,91,140,314
88,국정원,79,112,122,313
113,차량,67,64,181,312
90,지원,78,104,128,310
47,청구,105,82,121,308
74,기소,85,84,138,307
145,주민,57,95,154,306
60,아들,91,57,158,306
36,대법원,124,108,72,304
173,공무원,51,79,173,303
53,조작,99,84,120,303
109,문제,69,75,151,295
117,추가,66,65,163,294
64,사람,89,80,124,293
134,사법,59,161,70,290
48,기각,105,75,109,289
63,가족,90,57,141,288
110,단체,69,86,130,285
77,유출,82,74,127,283
65,판결,89,101,91,281
155,신고,55,47,177,279
298,교육,36,136,106,278
72,몰카,86,19,173,278
232,양승태,42,156,77,275
107,고발,70,90,113,273
197,요구,46,82,144,272
100,사장,73,94,103,270
66,소송,89,74,106,269
82,대법,81,111,75,267
105,체포,71,46,147,264
99,실종,73,52,132,257
149,확인,57,64,136,257
131,난민,61,78,117,256
81,모두,82,70,102,254
221,영상,43,114,94,251
92,다스,78,93,80,251
95,남편,76,30,144,250
78,서울시,82,74,91,247
191,농단,48,134,64,246
58,확정,93,83,70,246
154,입건,55,43,147,245
138,엄마,58,64,123,245
678,노동자,19,168,57,244
115,거래,67,65,111,243
1680,일상,6,13,223,242
161,부인,54,54,133,241
202,업체,45,62,134,241
126,심사,62,49,130,241
216,흉기,43,24,173,240
125,결정,62,79,99,240
103,부상,71,48,121,240
271,확대,38,101,100,239
140,피의자,58,65,115,238
193,최저임금,47,104,85,236
97,아내,74,28,133,235
160,집단,54,56,124,234
71,뇌물,86,66,80,232
25,개최,169,18,44,231
203,반대,45,87,99,231
135,사기,59,37,134,230
127,간부,62,50,117,229
205,범죄,44,42,143,229
86,버스,79,47,102,228
281,안전,37,53,136,226
164,사실,53,64,109,226
98,구형,74,54,98,226
118,사과,66,58,100,224
376,대학,31,94,99,224
183,강제,49,68,106,223
162,관련,54,45,123,222
340,지역,32,121,68,221
121,실형,66,33,121,220
120,집회,66,60,90,216
111,항소심,69,46,100,215
578,적발,22,43,149,214
536,선거,23,137,53,213
151,책임,56,60,97,213
166,청원,53,32,126,211
330,사업,33,73,105,211
119,증거,66,59,84,209
196,중단,46,68,93,207
171,위해,52,59,93,204
158,국가,55,73,75,203
455,참사,26,52,123,201
243,지사,41,102,58,201
258,경기,39,117,45,201
89,부장,78,49,73,200
150,폭로,57,45,98,200
188,인권,48,92,59,199
122,추락,64,38,96,198
83,시위,81,42,75,198
215,성희롱,43,52,103,198
94,총장,76,68,53,197
379,폐지,30,76,89,195
123,횡령,63,43,89,195
181,세종,49,53,92,194
256,어린이집,39,57,98,194
270,취업,38,49,106,193
186,기사,49,39,105,193
280,관리,37,43,112,192
279,검토,37,53,102,192
102,아빠,72,45,73,190
139,시신,58,8,124,190
207,공사,44,58,86,188
213,위반,43,66,79,188
136,국내,59,43,85,187
275,이상,38,61,87,186
179,착수,50,45,91,186
101,서울대,72,57,57,186
236,송치,41,41,103,185
157,추정,55,33,96,184
116,유죄,67,50,66,183
137,의사,59,33,91,183
169,택시,52,32,99,183
254,정보,40,80,63,183
214,시장,43,83,57,183
274,징계,38,50,94,182
228,긴급,42,38,102,182
184,공장,49,61,72,182
448,촬영,27,67,88,182
224,여고생,43,24,113,180
194,메르스,47,51,82,180
245,대응,41,45,93,179
284,협박,37,29,113,179
180,자금,50,55,74,179
128,하나,62,49,67,178
54,방송,97,43,38,178
165,주장,53,38,87,178
146,건물,57,33,88,178
153,정책,55,76,46,177
176,음주운전,50,30,97,177
159,연기,54,44,78,176
320,행정,34,102,40,176
129,장관,61,48,67,176
132,현직,60,44,72,176
374,허위,31,43,101,175
106,법정,71,35,68,174
96,세계,76,53,45,174
294,의심,36,43,94,173
192,금지,47,55,70,172
303,구조,35,33,104,172
347,발생,32,43,97,172
462,대책,26,64,82,172
372,청년,31,66,74,171
223,의료,43,41,86,170
76,이사장,83,42,45,170
69,부부,87,22,61,170
1356,교육감,8,126,36,170
229,집행유예,42,27,101,170
225,센터,42,63,63,168
244,공항,41,59,68,168
743,민주당,18,117,32,167
565,경찰관,22,18,126,166
56,지금,96,29,40,165
177,고속도로,50,51,63,164
266,시간,38,59,67,164
533,징역형,23,9,132,164
313,우려,34,44,86,164
168,벌금,52,32,79,163
201,이명박,46,62,55,163
852,평화,15,123,24,162
248,취소,40,44,78,162
473,운영,25,50,86,161
328,반발,33,59,68,160
237,지진,41,20,98,159
253,운동,40,59,60,159
283,대상,37,38,84,159
400,남북,29,95,34,158
142,원장,58,49,51,158
241,개입,41,65,52,158
198,포항,46,43,67,156
133,특활비,60,55,40,155
190,가장,48,48,59,155
148,문화,57,50,48,155
312,유족,34,44,75,153
390,경북,30,69,54,153
175,이윤택,51,38,63,152
147,대법관,57,59,35,151
235,북한,41,61,49,151
231,노인,42,33,76,151
238,고용,41,47,63,151
234,강원랜드,42,50,58,150
297,공원,36,75,39,150
219,고소,43,27,80,150
314,문건,34,57,59,150
211,공작,44,47,57,148
362,병역,31,55,62,148
226,차례,42,32,73,147
508,제천,24,37,86,147
255,발표,40,32,74,146
143,출신,58,32,56,146
304,가능성,35,19,91,145
217,헌재,43,50,51,144
301,눈물,35,46,63,144
401,합의,29,52,63,144
368,장애인,31,35,78,144
355,의견,31,38,75,144
187,청탁,49,44,51,144
450,확산,27,37,80,144
428,아버지,28,27,89,144
227,계속,42,46,55,143
414,가짜,28,56,59,143
338,자유,32,64,46,142
285,할머니,37,41,64,142
392,시도,30,31,79,140
519,세상,24,34,82,140
481,마을,25,65,50,140
403,설치,29,44,67,140
360,가해자,31,37,71,139
208,여부,44,28,67,139
443,비상,27,41,71,139
321,지시,34,46,59,139
655,청소년,20,54,65,139
152,국제,56,44,39,139
268,국회,38,44,56,138
84,주말,81,27,30,138
366,갈등,31,32,74,137
156,중국,55,21,61,137
411,시험,28,39,70,137
242,전자,41,48,48,137
699,경남,19,83,34,136
141,일본,58,51,27,136
185,배상,49,44,42,135
195,곳곳,47,47,41,135
426,결과,28,30,77,135
413,도로,28,37,70,135
339,일부,32,44,59,135
289,회의,37,57,40,134
676,참여,19,69,46,134
354,여명,32,36,65,133
342,소방관,32,30,71,133
646,판매,20,34,79,133
163,강남,54,34,45,133
263,건강,39,46,48,133
404,다른,29,31,73,133
291,조치,36,26,71,133
539,시설,23,35,75,133
382,보수,30,57,45,132
222,기록,43,48,41,132
471,해외,26,25,80,131
770,진상,17,44,70,131
262,지하철,39,38,54,131
85,배우,80,18,33,131
466,업무,26,40,65,131
384,운전,30,20,81,131
416,동료,28,24,79,131
554,기간,23,37,70,130
480,소방,25,30,75,130
503,개혁,24,52,54,130
319,주의,34,53,43,130
144,석방,57,28,45,130
302,특별,35,47,47,129
399,필요,29,24,76,129
1107,노동,11,75,42,128
290,음주,36,17,75,128
574,양심,22,55,51,128
230,법무부,42,33,53,128
1456,촉구,8,65,54,127
325,보도,33,55,39,127
257,치료,39,20,68,127
380,사용,30,23,73,126
566,징용,22,68,36,126
206,방화,44,22,60,126
467,아동,26,35,65,126
299,위기,36,37,53,126
209,위원장,44,54,28,126
405,상습,29,21,75,125
306,폭력,35,28,62,125
252,교통사고,40,23,61,124
200,그룹,46,27,51,124
373,박원순,31,45,48,124
204,결혼,45,18,61,124
795,고교,16,39,69,124
286,사랑,37,46,41,124
334,친구,33,26,65,124
542,강화,23,33,67,123
501,외국인,25,21,77,123
1255,민주,9,80,34,123
361,시대,31,41,50,122
323,만취,33,13,76,122
337,화장실,32,23,67,122
425,기준,28,44,49,121
277,국정,37,41,43,121
406,부모,29,22,70,121
367,대피,31,22,67,120
282,충돌,37,28,55,120
1003,규명,13,44,63,120
435,운전자,27,10,82,119
318,보고,34,39,46,119
1734,인권위,5,72,42,119
300,불구속,35,34,50,119
422,성범죄,28,15,76,119
886,전남,15,63,40,118
333,작업,33,33,52,118
363,진실,31,36,51,118
1268,시민단체,9,61,48,118
172,기온,52,49,17,118
336,중앙,32,53,33,118
665,침해,20,41,56,117
353,때문,32,25,60,117
482,사찰,25,45,47,117
324,근로자,33,12,71,116
287,여자,37,33,46,116
377,임종헌,30,45,41,116
326,마약,33,18,65,116
468,일당,26,22,68,116
278,회사,37,29,50,116
597,비판,21,46,48,115
495,집유,25,10,80,115
612,벌금형,21,12,82,115
344,규모,32,23,60,115
220,경찰청장,43,22,50,115
381,모든,30,39,46,115
383,국민연금,30,46,38,114
986,임금,13,36,65,114
592,도입,21,50,43,114
419,진술,28,23,63,114
264,화폐,39,17,58,114
549,사퇴,23,34,56,113
311,도심,34,32,47,113
267,활동,38,34,41,113
212,새벽,44,22,46,112
488,사법부,25,25,62,112
843,단속,15,24,73,112
666,성매매,20,21,71,112
357,도주,31,10,70,111
719,학부모,18,27,66,111
440,가능,27,35,49,111
309,진화,35,27,49,111
429,인상,27,40,44,111
446,투자,27,18,66,111
350,역대,32,26,52,110
486,축제,25,50,35,110
247,가상,41,15,54,110
269,사상,38,28,44,110
910,학원,14,27,68,109
489,지방,25,49,35,109
167,재단,53,30,26,109
233,최초,42,33,34,109
602,환경,21,55,33,109
829,본격,16,40,53,109
734,위안부,18,51,40,109
250,용의자,40,17,51,108
460,특수,26,32,50,108
661,바람,20,50,38,108
494,대학생,25,23,60,108
469,장애,26,33,49,108
648,일자리,20,48,40,108
530,전직,24,36,48,108
386,요청,30,29,49,108
736,유포,18,29,61,108
894,정황,14,30,63,107
410,역사,28,47,32,107
595,학대,21,12,74,107
327,위험,33,27,47,107
272,수도권,38,47,22,107
398,과거,29,39,38,106
292,대신,36,20,50,106
438,어디,27,35,44,106
524,강도,24,22,60,106
587,제자,22,19,65,106
407,개발,29,48,29,106
491,지휘,25,27,54,106
596,원인,21,27,57,105
778,방치,17,20,68,105
576,제출,22,28,55,105
358,귀가,31,21,53,105
218,남자,43,17,44,104
308,아침,35,53,16,104
346,하라,32,39,33,104
332,선택,33,26,45,104
569,쓰레기,22,15,67,104
1262,직장,9,24,71,104
412,서비스,28,37,39,104
260,미국,39,35,30,104
259,재산,39,22,42,103
584,언론,22,59,22,103
210,감독,44,25,34,103
246,비서,41,27,35,103
449,문재인,27,40,36,103
516,수당,24,36,42,102
824,근무,16,25,61,102
452,이틀,27,30,44,101
453,처음,27,42,32,101
594,강원,21,52,28,101
553,법관,23,56,22,101
424,전쟁,28,32,41,101
296,자택,36,23,42,101
261,영향,39,34,28,101
583,초등생,22,21,57,100
497,적용,25,25,50,100
872,범행,15,16,69,100
557,자녀,23,23,54,100
442,확보,27,15,58,100
506,교통,24,30,46,100
509,철거,24,33,42,99
1103,부정,11,29,59,99
753,전환,17,47,35,99
799,보이스피싱,16,13,70,99
769,이용,17,32,50,99
842,해고,15,41,43,99
348,이후,32,25,42,99
888,어선,15,24,60,99
397,특혜,29,35,35,99
423,행사,28,27,43,98
2377,플러스,1,1,96,98
644,관계,20,25,53,98
359,사망자,31,15,52,98
585,거리,22,26,50,98
705,기억,19,53,26,98
356,강요,31,19,47,97
651,감사,20,43,33,96
329,블랙리스트,33,27,36,96
762,의무,17,29,50,96
550,결론,23,26,47,96
1023,개선,13,30,53,96
652,추모,20,42,34,96
1044,수색,12,22,62,96
276,남용,37,26,32,95
371,준비,31,20,44,95
1082,수능,11,43,41,95
845,교육부,15,45,35,95
478,판단,25,26,44,95
689,보험,19,26,50,95
265,대한민국,38,18,39,95
626,제한,21,24,50,95
567,복지,22,41,32,95
714,강진,19,17,58,94
543,차별,23,35,36,94
764,집중,17,20,57,94
249,산업,40,23,31,94
797,추행,16,12,66,94
739,해결,18,29,47,94
385,폭발,30,19,45,94
417,운행,28,24,42,94
485,기관,25,28,40,93
364,택배,31,18,44,93
796,논의,16,35,42,93
1770,증가,5,29,59,93
1303,희생,9,40,44,93
293,하늘,36,36,21,93
708,조폭,19,13,61,93
961,지방선거,14,55,24,93
529,무료,24,23,46,93
389,마음,30,28,35,93
1034,주택,12,30,50,92
476,얼굴,25,16,51,92
700,이제,19,39,34,92
408,핵심,29,34,29,92
316,기념,34,38,20,92
707,죽음,19,36,37,92
933,건설,14,30,48,92
538,자료,23,27,42,92
555,자살,23,14,54,91
240,수술,41,17,33,91
427,변호인,28,13,50,91
726,주의보,18,35,38,91
474,생각,25,21,45,91
370,입원,31,11,49,91
458,투신,26,14,51,91
447,승객,27,20,44,91
586,광고,22,21,48,91
647,도시,20,48,22,90
493,법정구속,25,20,45,90
637,의식,20,20,50,90
295,정체,36,24,30,90
568,청장,22,33,35,90
611,주차,21,12,57,90
605,성관계,21,11,58,90
1180,농성,10,50,29,89
1143,선언,11,48,30,89
800,사태,16,23,50,89
823,호선,16,38,35,89
687,목사,19,24,46,89
556,홍대,23,17,49,89
629,인명,21,19,49,89
580,처분,22,24,43,89
822,급증,16,19,54,89
790,처리,16,25,48,89
454,부당,27,19,43,89
502,군산,25,36,28,89
388,협력,30,28,31,89
1850,의회,5,63,21,89
579,투입,22,20,46,88
437,통보,27,23,38,88
1090,진보,11,54,23,88
663,예고,20,22,46,88
1552,충북,7,44,37,88
251,선수,40,24,24,88
1032,노총,12,53,23,88
544,조정,23,23,42,88
703,전두환,19,38,30,87
375,인천공항,31,22,34,87
1248,시행,9,34,44,87
504,본사,24,29,34,87
589,접촉,22,21,44,87
418,마리,28,19,40,87
1365,전북,8,38,40,86
465,주인,26,10,50,86
310,한강,35,28,23,86
432,감형,27,13,46,86
715,간호사,19,25,42,86
547,서지현,23,24,39,86
1004,출동,13,11,62,86
343,영화,32,27,27,86
656,전원,20,23,42,85
444,명예훼손,27,18,40,85
307,법무,35,10,39,84
1348,비정규직,8,39,37,84
507,광화문,24,29,31,84
919,예산,14,35,35,84
1643,사립,6,34,44,84
642,후배,20,23,41,84
498,붕괴,25,17,42,84
415,예술,28,28,28,84
540,동생,23,14,47,84
1108,부실,11,21,52,84
577,경비원,22,15,47,84
532,예정,23,25,36,84
479,공단,25,19,40,84
674,진행,19,12,53,84
526,김명수,24,22,38,84
1405,교육청,8,43,33,84
1593,출마,7,57,20,84
745,모녀,18,15,50,83
459,수사권,26,24,33,83
937,연장,14,25,44,83
978,보호,13,26,44,83
859,바다,15,29,39,83
607,계획,21,27,35,83
820,어린이,16,28,39,83
900,절반,14,27,41,82
393,전달,30,17,35,82
472,김기춘,26,26,30,82
351,한국인,32,12,38,82
749,정당,17,28,37,82
512,소환조사,24,12,46,82
548,이름,23,32,27,82
305,기술,35,19,28,82
561,머리,23,14,45,82
463,공범,26,11,45,82
913,주차장,14,20,47,81
518,가지,24,42,15,81
756,조직,17,26,38,81
1195,모집,10,20,51,81
600,해임,21,21,39,81
527,경제,24,35,22,81
1132,호소,11,16,53,80
510,난동,24,11,45,80
581,침대,22,14,44,80
667,항소,20,16,44,80
522,구치소,24,18,38,80
475,종로,25,20,35,80
608,지급,21,26,33,80
365,남부,31,31,18,80
754,인근,17,19,44,80
352,출산,32,10,38,80
610,편의점,21,12,47,80
742,효과,18,21,41,80
483,고양,25,32,23,80
1259,절도,9,3,67,79
1066,물질,12,24,43,79
606,경찰청,21,18,40,79
989,위협,13,14,52,79
710,수도,19,23,37,79
624,사형,21,20,38,79
880,광장,15,26,38,79
395,전문,29,12,38,79
732,등장,18,25,36,79
505,사위,24,26,29,79
1193,속도,10,18,51,79
1798,혐오,5,21,53,79
499,유해,25,30,24,79
752,정규직,17,38,24,79
664,공천,20,36,22,78
378,형사,30,15,33,78
445,분노,27,13,38,78
420,서도,28,25,25,78
925,극단,14,15,49,78
523,공동,24,34,20,78
528,입장,24,16,38,78
805,대란,16,16,46,78
1064,덜미,12,9,57,78
680,포기,19,24,34,77
317,육아,34,19,24,77
1271,금품,9,11,57,77
1120,훼손,11,19,47,77
1070,희망,12,24,41,77
649,무더기,20,18,39,77
621,보육,21,18,38,77
239,명예,41,20,15,76
632,카드,21,15,40,76
639,추적,20,10,46,76
957,누가,14,28,34,76
1086,점검,11,27,38,76
944,자전거,14,31,31,76
1142,담배,11,13,52,76
604,상대,21,8,47,76
500,권력,25,20,31,76
650,안태,20,26,30,76
1157,투표,10,33,33,76
874,평균,15,19,42,76
931,지지,14,33,28,75
369,기부,31,17,27,75
955,통일,14,39,22,75
387,전문가,30,13,32,75
984,헬기,13,26,36,75
633,원세훈,21,33,21,75
864,이웃,15,22,38,75
439,선물,27,20,28,75
759,폐쇄,17,19,39,75
1232,보장,10,33,32,75
1471,유통,7,14,54,75
349,주년,32,20,22,74
942,알바,14,15,45,74
521,대형,24,19,31,74
625,게임,21,22,31,74
885,규제,15,16,43,74
599,승용차,21,12,41,74
854,나선,15,13,46,74
402,시인,29,20,25,74
645,사이트,20,10,44,74
1296,과태료,9,20,45,74
514,남친,24,5,45,74
545,수수,23,23,28,74
335,작년,33,10,31,74
603,혁신,21,36,17,74
573,탈출,22,12,39,73
396,연금,29,20,24,73
1126,목소리,11,37,25,73
876,제기,15,14,44,73
692,잘못,19,20,34,73
288,이혼,37,6,30,73
484,실장,25,15,33,73
430,카페,27,9,37,73
972,가해,13,29,31,73
1526,전면,7,29,37,73
672,주기,19,34,19,72
788,소득,16,26,30,72
686,도박,19,8,45,72
619,먼저,21,19,32,72
457,마스크,26,21,25,72
1016,감염,13,18,41,72
331,위원,33,23,16,72
809,음성,16,26,30,72
902,파문,14,19,39,72
670,호텔,20,13,39,72
709,동영상,19,6,47,72
887,방해,15,16,40,71
551,측근,23,23,25,71
1095,행위,11,13,47,71
571,모델,22,24,25,71
673,파면,19,22,30,71
1581,가로,7,10,54,71
273,협회,38,12,21,71
178,이야기,50,15,6,71
609,출근길,21,28,21,70
1043,대화,12,28,30,70
718,합동,18,18,34,70
635,해상,21,12,37,70
830,죄송,16,17,37,70
782,선임,17,24,29,70
394,연구,30,16,23,69
1233,당신,10,20,39,69
922,여론,14,21,34,69
622,보복,21,10,38,69
456,선정,26,18,25,69
728,어머니,18,13,38,69
588,공정위,22,23,24,69
792,욕설,16,10,43,69
962,권고,13,32,24,69
903,미수,14,8,47,69
1486,촛불,7,37,24,68
461,대부분,26,19,23,68
751,문자,17,11,40,68
541,정치자금,23,19,26,68
559,외압,23,14,31,68
431,회원,27,12,29,68
490,안해,25,19,24,68
409,걱정,29,14,25,68
582,최종,22,21,25,68
727,돌파,18,11,39,68
492,보좌,25,15,28,68
189,연구원,48,10,9,67
1835,상고,5,34,28,67
1027,보상,12,12,43,67
959,축소,14,19,34,67
643,평양,20,31,16,67
729,조선,18,30,19,67
1019,무단,13,7,47,67
1001,미성년,13,13,41,67
1104,고교생,11,13,43,67
315,적폐,34,18,14,66
1609,이전,6,40,20,66
1000,수거,13,13,40,66
685,방문,19,20,27,66
433,나라,27,14,25,66
873,도전,15,36,15,66
704,법인,19,10,37,66
724,문무,18,23,25,66
1138,용인,11,24,31,66
893,부담,14,17,35,66
827,유명,16,14,35,65
1774,예비,5,23,37,65
560,롯데,23,16,26,65
974,현금,13,16,36,65
572,폭언,22,8,35,65
1115,관심,11,16,38,65
999,남매,13,13,39,65
1042,증언,12,13,40,65
1713,제도,6,26,33,65
723,근로,18,25,22,65
1533,여친,7,4,53,64
1171,동거,10,1,53,64
1200,관광객,10,17,37,64
620,개인,21,12,31,64
683,발령,19,15,30,64
741,예상,18,13,33,64
487,치매,25,11,28,64
434,인터넷,27,11,26,64
525,가구,24,12,28,64
691,상태,19,8,37,64
688,몰래,19,7,37,63
1139,전교조,11,33,19,63
825,공식,16,24,23,63
1227,수업,10,29,24,63
1174,동원,10,24,29,63
1173,수용,10,21,32,63
1154,합격,10,9,44,63
863,수준,15,22,26,63
345,플라스틱,32,13,18,63
1124,검증,11,24,28,63
713,스님,19,23,21,63
520,파기,24,15,24,63
660,법원행정처,20,29,14,63
1863,철회,4,30,29,63
1028,당국,12,8,43,63
513,종교,24,15,24,63
1009,퇴직,13,22,28,63
657,무슨,20,15,28,63
613,경고,21,11,31,63
798,교장,16,19,28,63
534,회복,23,20,20,63
814,무기징역,16,13,33,62
1769,평가,5,26,31,62
926,예방,14,17,31,62
1213,고의,10,12,40,62
1072,출근,12,21,29,62
681,소리,19,15,28,62
1076,월급,12,27,23,62
2274,부산시,2,47,13,62
1513,공공기관,7,26,29,62
807,대가,16,19,27,62
464,다음,26,19,17,62
783,의장,17,32,12,61
737,설립,18,30,13,61
1186,여학생,10,12,39,61
815,질문,16,25,20,61
725,무혐의,18,12,31,61
841,전화,15,16,30,61
617,구속기소,21,14,26,61
958,직장인,14,12,35,61
675,응급실,19,12,30,61
818,실명,16,13,32,61
690,식당,19,10,32,61
938,허가,14,21,26,61
1020,출범,13,30,17,60
641,민간,20,23,17,60
949,교체,14,24,22,60
614,강용석,21,3,36,60
341,간다,32,11,17,60
808,가스,16,16,28,60
856,불안,15,11,34,60
740,통해,18,9,33,60
738,비공개,18,22,20,60
836,모텔,16,5,39,60
593,이사,21,28,11,60
1062,급여,12,12,36,60
322,김정은,33,8,19,60
1006,수원,13,27,20,60
784,여름,17,21,22,60
920,동물,14,16,30,60
1254,업자,9,17,34,60
1679,학년,6,24,29,59
932,동의,14,11,34,59
1700,생활,6,24,29,59
679,순간,19,28,12,59
511,훈련,24,11,24,59
1041,단계,12,12,35,59
975,여중생,13,6,40,59
695,집행,19,14,26,59
531,행정권,23,18,18,59
744,강제추행,18,11,30,59
844,절차,15,21,23,59
831,분석,16,12,31,59
1228,조성,10,27,22,59
570,발부,22,11,26,59
1293,과정,9,18,32,59
835,재개,16,24,19,59
591,배임,21,15,22,58
896,구성,14,25,19,58
517,보석,24,11,23,58
1022,기획,13,21,24,58
917,일베,14,11,33,58
1178,강릉,10,20,28,58
562,여행,23,15,20,58
777,연루,17,8,33,58
943,불개미,14,9,35,58
1165,식약처,10,3,45,58
1384,고통,8,22,28,58
954,돼지,14,16,28,58
537,국회의원,23,15,20,58
757,정상,17,18,23,58
1046,부족,12,15,30,57
698,항의,19,12,26,57
436,인생,27,11,19,57
969,성적,13,12,32,57
771,생명,17,14,26,57
558,마트,23,8,26,57
918,사무실,14,21,22,57
712,신동빈,19,12,26,57
684,패소,19,6,32,57
677,포함,19,16,22,57
552,차장,23,12,22,57
1067,마무리,12,13,32,57
928,민주주의,14,27,16,57
927,남녀,14,10,33,57
956,이영학,14,12,31,57
1812,제공,5,23,29,57
1203,정신,10,26,21,57
868,협조,15,12,30,57
802,귀국,16,12,29,57
470,법적,26,13,18,57
1359,충남,8,27,22,57
1454,주목,8,26,22,56
1402,일반,8,23,25,56
846,반성,15,16,25,56
875,무산,15,19,22,56
1011,유지,13,15,28,56
563,전복,23,14,19,56
1122,통제,11,17,28,56
598,생중계,21,16,19,56
1519,지정,7,28,21,56
1560,해경,7,10,39,56
780,장기,17,18,21,56
696,주식,19,6,30,55
1324,산재,9,19,27,55
1119,김해,11,20,24,55
1509,경험,7,20,28,55
930,바로,14,15,26,55
628,정전,21,9,25,55
1411,제품,8,11,36,55
1084,첫날,11,15,29,55
1015,인구,13,19,23,55
1038,임원,12,13,30,55
1879,면접,4,20,31,55
750,목숨,17,7,31,55
2135,노무현,3,28,24,55
889,은폐,14,19,22,55
2199,이슈,2,4,49,55
945,실패,14,20,20,54
1281,최저,9,25,20,54
941,영업,14,11,29,54
697,고민,19,16,19,54
1212,지인,10,6,38,54
421,가을,28,15,11,54
1060,거짓,12,11,31,54
1078,응원,12,24,18,54
1092,권리,11,23,20,54
1420,대비,8,11,35,54
1328,주변,9,16,29,54
1580,대입,7,33,14,54
623,아시아나,21,10,23,54
992,민원,13,17,23,53
618,탈세,21,9,23,53
1349,공약,8,31,14,53
1302,파업,9,25,19,53
477,경찰서,25,10,18,53
1469,방안,7,19,27,53
564,태극기,23,10,20,53
1106,속출,11,13,29,53
1170,지자체,10,15,28,53
627,협의,21,15,17,53
1035,강력,12,16,25,53
631,소동,21,5,27,53
869,은행,15,15,23,53
721,정지,18,18,17,53
801,개방,16,22,15,53
758,공연,17,26,10,53
812,타고,16,16,21,53
811,해소,16,14,23,53
763,권성동,17,18,18,53
826,진료,16,14,23,53
858,공부,15,18,20,53
1209,음란,10,4,38,52
817,데이트,16,5,31,52
1052,우선,12,20,20,52
1534,돌입,7,13,32,52
851,부검,15,6,31,52
929,환경부,14,18,20,52
659,진짜,20,14,18,52
803,노출,16,10,26,52
1913,지난해,4,23,25,52
515,사이,24,9,19,52
1176,손님,10,9,33,52
882,제안,15,21,16,52
906,새마을금고,14,12,26,52
973,감정,13,10,29,52
1160,노후,10,13,29,52
2098,개정,3,21,28,52
1554,당선,7,30,15,52
1549,교회,7,19,25,51
849,적극,15,9,27,51
866,배달,15,12,24,51
636,대선,21,18,12,51
1024,허용,12,14,25,51
441,세대,27,10,14,51
535,세금,23,11,17,51
1295,감시,9,19,23,51
765,혼자,17,11,23,51
1312,관여,9,9,33,51
839,폭탄,15,9,27,51
907,방침,14,18,19,51
911,내사,14,11,26,51
877,해명,15,10,26,51
1245,실시,9,12,30,51
630,특보,21,17,13,51
881,억대,15,13,23,51
878,조윤선,15,16,20,51
658,종합,20,8,23,51
451,여배우,27,11,13,51
1422,재심,8,23,20,51
1304,분향소,9,22,19,50
1806,뿌리,5,21,24,50
1068,비난,12,9,29,50
964,밀수,13,9,28,50
671,저출산,20,11,19,50
914,자연,14,18,18,50
733,편지,18,20,12,50
2095,재난,3,15,32,50
1184,변경,10,10,30,50
1363,인재,8,16,26,50
1516,규탄,7,19,24,50
1091,유가족,11,14,25,50
601,토론회,21,13,16,50
1357,노량진,8,15,27,50
716,용산,19,13,18,50
1854,통과,5,19,26,50
706,원정,19,9,21,49
575,반박,22,3,24,49
995,일가,13,18,18,49
668,금융,20,6,23,49
838,중국인,15,3,31,49
1439,공포,8,9,32,49
1393,언제,8,18,23,49
1140,질환,11,13,25,49
983,홍보,13,17,19,49
748,무효,17,12,20,49
2119,꼼수,3,21,25,49
1206,복귀,10,15,24,49
1134,민간인,11,22,16,49
1224,식중독,10,4,35,49
1112,배제,11,18,19,48
1059,성공,12,11,25,48
1111,복직,11,17,20,48
640,수석,20,11,17,48
1591,최악,7,17,24,48
848,침묵,15,10,23,48
1137,입국,11,5,32,48
1073,선원,12,5,31,48
1217,동네,10,13,25,48
615,강서,21,7,20,48
1954,라며,4,2,42,48
1151,충격,11,6,31,48
1047,막말,12,13,23,48
1697,사흘,6,19,23,48
1569,경비,7,15,26,48
1036,침입,12,6,30,48
1412,인력,8,11,29,48
2113,여전,3,12,33,48
971,현대,13,20,15,48
1754,마당,5,33,10,48
1366,기무사,8,16,24,48
1695,현실,6,10,32,48
746,국장,17,17,13,47
1532,아동학대,7,10,30,47
722,위헌,18,13,16,47
1189,자격,10,9,28,47
884,내부,15,14,18,47
662,정권,20,10,17,47
391,신임,30,7,10,47
776,상처,17,12,18,47
761,인기,17,13,17,47
1008,삭제,13,12,22,47
711,민변,19,13,15,47
590,지지자,22,4,21,47
1202,이동,10,13,24,47
1246,명의,9,16,22,47
1423,체험,8,23,16,47
785,차관,16,14,17,47
747,원금,17,12,18,47
985,심의,13,17,17,47
793,돌진,16,4,27,47
979,고문,13,24,10,47
731,행복,18,14,15,47
976,투약,13,3,30,46
1484,불허,7,14,25,46
1505,시절,7,9,30,46
857,체류,15,7,24,46
702,신문,19,20,7,46
1445,선거법,8,23,15,46
810,판정,16,14,16,46
867,외부,15,11,20,46
717,부영,18,7,21,46
735,검찰총장,18,15,13,46
1797,소비자,5,4,37,46
1778,조카,5,14,27,46
1751,가정,5,8,33,46
1286,급식,9,11,26,46
669,북상,20,15,11,46
2255,노동계,2,29,15,46
916,최소,14,14,18,46
1780,알바생,5,4,37,46
834,싸움,16,15,15,46
1639,휴대전화,6,4,35,45
1241,지속,10,13,22,45
1116,거짓말,11,12,22,45
693,내달,19,9,17,45
909,당한,14,11,20,45
1821,본부,5,12,28,45
821,추돌,16,6,23,45
1063,운영자,12,15,18,45
755,다리,17,10,18,45
1536,심각,7,9,29,45
908,스마트폰,14,8,23,45
963,알몸,13,8,24,45
616,대사,21,10,14,45
1257,노사,9,23,13,45
730,변론,18,13,14,45
1236,여직원,10,7,28,45
1449,업주,8,4,33,45
993,계약,13,14,18,45
1197,배출,10,24,11,45
1275,소녀,9,19,17,45
1481,드론,7,14,24,45
1099,유기,11,7,27,45
1284,음식,9,12,24,45
1443,부동산,8,18,19,45
2139,전주,3,23,19,45
546,스타,23,13,9,45
1602,자치,6,20,19,45
653,구한,20,5,20,45
774,총리,17,14,13,44
837,라인,16,12,16,44
1282,손해배상,9,13,22,44
1187,상황,10,9,25,44
1819,교류,5,27,12,44
1300,약속,9,19,16,44
1407,신체,8,6,30,44
819,연인,16,8,20,44
1550,고객,7,9,28,44
786,이중근,16,4,24,44
781,흔적,17,12,15,44
1219,자매,10,7,27,44
1419,중학생,8,12,24,44
1030,차로,12,11,21,44
1010,소장,13,6,25,44
997,중상,13,5,26,44
1125,그대로,11,16,17,44
1524,반응,7,6,31,44
1054,법률,12,7,25,44
1502,고양이,7,10,27,44
968,배당,13,23,8,44
1057,취재,12,19,13,44
1098,무시,11,8,25,44
1005,불복,13,7,24,44
1133,케어,11,8,25,44
1196,인증,10,9,24,43
1012,앞바다,13,8,22,43
1375,농도,8,20,15,43
1267,책임자,9,14,20,43
1638,변화,6,20,17,43
1379,증인,8,7,28,43
634,변협,21,8,14,43
1056,고장,12,9,22,43
1253,대기,9,13,21,43
1014,도움,13,7,23,43
1313,중형,9,13,21,43
682,직권남용,19,10,14,43
1858,중심,5,20,18,43
1166,생존자,10,16,17,43
694,필리핀,19,5,19,43
1292,목포,9,17,17,43
1416,입학,8,10,25,43
1037,중요,12,8,23,43
1543,치사,7,9,27,43
1415,군인,8,13,22,43
828,상자,16,6,20,42
638,최경환,20,7,15,42
1400,독도,8,13,21,42
1714,지구,6,23,13,42
1310,감소,9,10,23,42
1194,사관,10,14,18,42
850,실질,15,11,16,42
1660,신설,6,20,16,42
1331,파악,9,10,23,42
840,노력,15,7,20,42
1230,무면허,10,3,29,42
977,자기,13,9,20,42
895,의뢰,14,7,21,42
1208,정말,10,7,25,42
1211,독립,10,22,10,42
1039,형량,12,7,23,42
1696,대중교통,6,17,19,42
1156,도피,10,12,20,42
1870,취해,4,2,36,42
1599,친부,7,6,29,42
1153,필로폰,10,5,27,42
1468,온라인,7,8,27,42
990,퇴진,13,15,14,42
1906,원룸,4,8,30,42
1161,가방,10,8,24,42
1273,고향,9,19,14,42
1542,사례,7,14,21,42
898,천안,14,7,20,41
1315,로스쿨,9,4,28,41
1387,명품,8,8,25,41
1478,등록,7,13,21,41
1368,접근,8,15,18,41
1659,통합,6,24,11,41
936,아래,14,9,18,41
1058,여자친구,12,4,25,41
1251,포착,9,13,19,41
1480,뇌물수수,7,9,25,41
2133,군수,3,19,19,41
2006,만원,3,9,29,41
1708,현대차,6,20,15,41
1249,요금,9,12,20,41
1355,회삿돈,8,11,22,41
912,휴대폰,14,7,20,41
946,수첩,14,15,12,41
1341,로비,9,17,15,41
1437,전기,8,11,22,41
1123,시스템,11,11,19,41
861,고속,15,6,20,41
1512,방법,7,11,23,41
496,아시아,25,8,8,41
1673,엄벌,6,8,27,41
1406,구멍,8,11,22,41
1500,직업,7,13,21,41
1830,자체,5,13,23,41
1517,헌법,7,13,21,41
1318,건보,9,6,26,41
1488,구역,7,11,23,41
1128,창고,11,12,18,41
1597,비밀,7,15,19,41
948,불편,14,7,20,41
871,창업,15,8,18,41
1083,강사,11,5,25,41
1148,유감,11,13,17,41
2392,관계자,1,7,32,40
832,통영,16,11,13,40
1507,시청,7,17,16,40
2111,사연,3,9,28,40
1522,대한,7,19,14,40
1574,평택,7,16,17,40
720,전담,18,5,17,40
1168,식품,10,8,22,40
1551,불만,7,7,26,40
775,사무,17,12,11,40
939,상해,14,8,18,40
1563,사인,7,6,27,40
1025,제대로,12,12,16,40
1323,여경,9,2,29,40
1175,가입,10,10,20,40
1299,노래방,9,5,26,40
772,코리아,17,11,12,40
1214,보험금,10,4,26,40
883,동안,15,15,10,40
1856,선생님,5,14,21,40
1235,임신,10,11,19,40
980,초등학교,13,11,16,40
892,대리,14,7,19,40
1087,결식,11,13,16,40
1085,경쟁,11,12,17,40
813,부자,16,7,17,40
1013,한번,13,9,18,40
760,배소,17,7,16,40
947,의인,14,8,18,40
1429,상가,8,5,27,40
891,고용부,14,18,8,40
1390,자신,8,9,23,40
1204,애인,10,5,24,39
1351,음란물,8,9,22,39
1231,이송,10,8,21,39
1352,수상,8,17,14,39
1144,공익,11,11,17,39
1703,전과,6,4,29,39
1418,운명,8,15,16,39
1600,사전,7,13,19,39
1229,신뢰,10,13,16,39
2063,시급,3,15,21,39
1234,순직,10,8,21,39
950,질주,14,10,15,39
1455,보고서,8,22,9,39
1669,반복,6,11,22,39
966,점거,13,12,14,39
890,연합,14,12,13,39
1432,전망,8,7,24,39
1017,유서,13,11,15,39
1868,선발,4,10,25,39
1717,정의,6,18,15,39
767,태양광,17,15,7,39
935,선처,14,5,20,39
1557,작성,7,12,20,39
1610,불가피,6,12,21,39
1968,찬성,4,19,16,39
1336,열차,9,8,21,38
1316,부대,9,12,17,38
915,범인,14,5,19,38
1311,수습,9,7,22,38
789,주사,16,6,16,38
934,김포,14,11,13,38
1074,재범,12,7,19,38
1608,무상,6,19,13,38
1192,감금,10,8,20,38
1199,서류,10,9,19,38
1661,화물차,6,2,30,38
1802,전수,5,18,15,38
1665,장치,6,10,22,38
1218,셀프,10,18,10,38
1388,위법,8,15,15,38
794,연락,16,4,18,38
1288,면허,9,7,22,38
1475,대학가,7,2,29,38
1147,출장,11,14,13,38
1239,수입,10,4,24,38
1413,관광,8,12,18,38
1061,인간,12,14,12,38
1568,스프링클러,7,12,19,38
1050,제작,12,12,14,38
1702,수익,6,7,25,38
2370,장자연,1,15,22,38
1049,드라마,12,17,9,38
1935,비용,4,11,23,38
1862,창원,4,21,13,38
1094,도서관,11,14,13,38
951,옥중,14,7,16,37
1414,행동,8,12,17,37
804,소명,16,9,12,37
1394,제외,8,10,19,37
1427,주행,8,13,16,37
1378,심판,8,17,12,37
1377,상사,8,6,23,37
1340,상납,9,16,12,37
1380,불명,8,8,21,37
1279,생산,9,11,17,37
701,인도,19,8,10,37
1201,도착,10,7,20,37
833,줄줄이,16,12,9,37
905,압박,14,9,14,37
1040,심신,12,8,17,37
1887,비율,4,9,24,37
1065,프로포폴,12,7,18,37
1287,고려,9,8,20,37
1265,자사고,9,18,10,37
1167,출국,10,6,21,37
1971,발암,4,12,21,37
1117,유력,11,12,14,37
1497,청주,7,11,19,37
1158,모욕,10,3,24,37
1260,정치권,9,10,17,36
862,임명,15,8,13,36
1369,위증,8,11,17,36
1250,끝내,9,12,15,36
952,실수,14,5,17,36
1474,오토바이,7,3,26,36
879,항공기,15,7,14,36
1183,스트레스,10,8,18,36
654,인터뷰,20,8,8,36
901,스스로,14,8,14,36
1071,여의도,12,11,13,36
1385,개막,8,21,7,36
779,터미널,17,4,15,36
1077,편파,12,8,16,36
1080,혜택,11,11,14,36
1395,기회,8,16,12,36
1544,방지,7,12,17,36
1472,회수,7,5,24,36
2075,농민,3,22,11,36
773,나들이,17,4,15,36
1289,벌써,9,9,18,36
1629,춘천,6,13,17,36
2037,분양,3,13,20,36
1434,농장,8,9,19,36
1007,직무,13,10,13,36
1452,위력,8,14,14,36
768,묵묵,17,5,14,36
1146,종결,11,7,17,35
1306,제거,9,9,17,35
897,화상,14,4,17,35
1018,나이,13,8,14,35
970,불륜,13,3,19,35
1885,신도,4,9,22,35
1191,해당,10,4,21,35
1670,치유,6,19,10,35
1547,접수,7,7,21,35
1495,부하,7,5,23,35
2053,해제,3,15,17,35
1417,의미,8,10,17,35
1715,근거,6,15,14,35
1457,보안,8,11,16,35
965,통화,13,6,16,35
1163,전체,10,4,21,35
1321,장서,9,7,19,35
870,신상,15,6,14,35
1644,도지사,6,21,8,35
1079,전무,12,10,13,35
1859,학과,5,13,17,35
2356,개정안,1,17,17,35
1374,트럭,8,11,16,35
1329,염동열,9,11,15,35
1376,시비,8,3,24,35
1458,홀로,8,10,17,35
1619,위조,6,5,24,35
1627,운전기사,6,10,19,35
1791,크레인,5,8,22,35
1270,전역,9,10,16,35
1779,명령,5,6,24,35
1561,옥상,7,7,21,35
1611,여교사,6,4,25,35
1221,개인정보,10,10,15,35
1364,육아휴직,8,10,17,35
1421,뺑소니,8,4,22,34
1595,무사,7,5,22,34
1441,피고인,8,12,14,34
1570,운항,7,11,16,34
1618,외면,6,10,18,34
1461,승차,7,9,18,34
1453,선박,8,11,15,34
2153,정시,3,22,9,34
2128,차단,3,7,24,34
1613,시내버스,6,8,20,34
1647,지적,6,9,19,34
1579,외국,7,6,21,34
1556,프로그램,7,6,21,34
2157,대학교,2,5,27,34
1555,규정,7,7,20,34
1053,일회용,12,11,11,34
1320,쟁점,9,12,13,34
1889,보조금,4,10,20,34
1127,헌법재판관,11,13,10,34
1263,전용,9,13,12,34
1130,조롱,11,7,16,34
1327,계좌,9,6,19,34
1152,총수,11,8,15,34
1317,권한,9,10,15,34
1118,장학금,11,8,15,34
1814,제보,5,11,18,34
1182,하자,10,17,7,34
1185,진단,10,5,19,34
1226,주도,10,12,12,34
2009,카톡,3,10,21,34
1240,자진,10,9,15,34
853,더니,15,6,13,34
899,휠체어,14,9,11,34
1278,특정,9,8,17,34
1382,봇물,8,13,13,34
1347,중인,8,6,20,34
1114,변호,11,7,16,34
1667,위로,6,16,12,34
806,육군,16,3,15,34
1051,봉사,12,6,16,34
1101,미약,11,7,16,34
1055,친환경,12,12,9,33
988,감옥,13,11,9,33
1857,오염,5,13,15,33
1237,상실,10,11,12,33
1799,종료,5,6,22,33
1210,경주,10,6,17,33
1810,복구,5,5,23,33
1026,감식,12,4,17,33
1953,상담,4,11,18,33
1817,대출,5,6,22,33
1601,오피스텔,7,7,19,33
1105,박상기,11,8,14,33
1831,어금니,5,10,18,33
1510,의문,7,8,18,33
1839,탄핵,5,14,14,33
1048,격리,12,5,16,33
2152,협약,3,15,15,33
1031,영아,12,5,16,33
1102,소방차,11,3,19,33
1410,반입,8,9,16,33
1446,청소,8,8,17,33
1881,복원,4,19,10,33
1747,성남,5,15,13,33
1650,실태,6,10,17,33
1562,활용,7,18,8,33
1345,경상,8,9,16,33
1566,불가,7,6,20,33
1757,행인,5,5,23,33
1367,진입,8,4,21,33
847,백화점,15,6,12,33
1290,불참,9,7,17,33
816,법조,16,10,7,33
1688,당시,6,7,20,33
1624,요양,6,5,22,33
1442,결함,8,4,21,33
1464,보건,7,10,16,33
953,얘기,14,6,13,33
1346,포천,8,10,14,32
860,기상청,15,5,12,32
2148,근절,3,7,22,32
1772,완전,5,10,17,32
1707,대규모,6,14,12,32
1113,골프,11,3,18,32
1444,목표,8,10,14,32
1656,공급,6,9,17,32
766,조국,17,5,10,32
1100,수감,11,9,12,32
1093,공짜,11,9,12,32
1426,취하,8,8,16,32
1401,내용,8,4,20,32
1508,전자담배,7,9,16,32
1967,최근,4,8,20,32
994,국정원장,13,7,12,32
1198,우린,10,12,10,32
1243,가사,10,3,19,32
1242,무고,10,5,17,32
1877,대안,4,17,11,32
1762,중고,5,3,24,32
1223,기름,10,5,17,32
1141,해양,11,9,12,32
1787,대처,5,11,16,32
1912,차질,4,8,20,32
1537,상징,7,19,6,32
1181,압수,10,6,16,32
921,환송,14,1,17,32
1145,직전,11,8,13,32
991,일선,13,7,11,31
1924,체제,4,10,17,31
981,노래,13,14,4,31
1880,타이어,4,7,20,31
987,공정,13,10,8,31
1572,설명,7,12,12,31
1605,납품,6,5,20,31
1307,동결,9,7,15,31
1238,낙태,10,10,11,31
1397,우울증,8,6,17,31
2091,행안부,3,9,19,31
1712,초과,6,8,17,31
1333,선거운동,9,13,9,31
1727,조희연,5,11,15,31
1280,대진,9,3,19,31
1463,기본,7,9,15,31
1997,사무장,4,6,21,31
787,후원,16,4,11,31
1990,교복,4,18,9,31
1585,체포영장,7,6,18,31
1664,비방,6,7,18,31
1136,방향,11,11,9,31
1075,코치,12,5,14,31
1089,탄생,11,13,7,31
1940,청사,4,16,11,31
1504,소통,7,11,13,31
1892,출입,4,12,14,30
1691,빌딩,6,8,16,30
1716,농가,6,6,18,30
1724,이별,6,5,19,30
1740,동포,5,9,16,30
2040,양성,3,10,17,30
1987,몸살,4,4,22,30
1741,유발,5,8,17,30
2132,암매장,3,5,22,30
2033,조명,3,8,19,30
1565,차이,7,8,15,30
1575,사정,7,12,11,30
2023,입시,3,11,16,30
1753,능력,5,6,19,30
1577,지하,7,8,15,30
1898,얼마나,4,12,14,30
1190,공격,10,7,13,30
1305,중독,9,4,17,30
1501,참변,7,6,17,30
2164,미끼,2,4,24,30
1518,선배,7,7,16,30
1487,사체,7,4,19,30
1520,담당,7,8,15,30
1155,역할,10,6,14,30
1159,외출,10,9,11,30
1339,민중,9,10,11,30
1465,접대,7,7,16,30
1309,거절,9,8,13,30
1362,다툼,8,10,12,30
1276,친형,9,9,12,30
1222,요원,10,8,12,30
865,나눔,15,8,7,30
1081,동덕여대,11,6,12,29
1742,괴물,5,8,16,29
1813,강행,5,12,12,29
1179,지대,10,4,15,29
1826,야간,5,6,18,29
1796,의지,5,7,17,29
1626,박탈,6,6,17,29
1635,메모,6,5,18,29
1247,대체,9,10,10,29
1786,이메일,5,7,17,29
2240,과제,2,11,16,29
1645,공감,6,9,14,29
1088,납치,11,2,16,29
1588,재해,7,9,13,29
1837,민주화,5,15,9,29
1391,실험,8,14,7,29
1672,발화,6,8,15,29
1895,창문,4,7,18,29
1506,서명,7,14,8,29
1029,정도,12,5,12,29
1396,고백,8,8,13,29
1884,만남,4,10,15,29
1338,종업원,9,4,16,29
1335,서해,9,10,10,29
982,윤석열,13,9,7,29
1893,반려견,4,3,22,29
1559,여객선,7,11,11,29
1383,포르노,8,1,20,29
1586,유령,7,9,12,28
940,염려,14,8,6,28
1800,수급,5,6,17,28
1314,장비,9,7,12,28
1425,제명,8,5,15,28
904,탑승,14,3,11,28
1285,윤리,9,5,14,28
1372,장사,8,5,15,28
1630,사각,6,5,17,28
2172,구매,2,6,20,28
1373,손실,8,7,13,28
1256,월드,9,5,14,28
1258,기능,9,4,15,28
2131,사범,3,7,18,28
2001,고성,4,4,20,28
2281,체납,2,4,22,28
1188,다음주,10,8,10,28
1616,매달,6,6,16,28
1937,가담,4,5,19,28
1603,게시,6,5,17,28
1589,내주,7,8,13,28
1021,구급차,13,2,13,28
2058,소유,3,12,13,28
1097,전력,11,3,14,28
2246,상승,2,13,13,28
998,항공사,13,3,12,28
2249,알선,2,3,23,28
1731,기대,5,8,15,28
1840,일대,5,7,16,28
2369,기계,1,12,15,28
1966,행진,4,12,12,28
1150,대검,11,9,8,28
1164,일단,10,5,13,28
2140,신입생,3,5,20,28
1573,안정,7,9,12,28
1735,기숙사,5,7,16,28
2118,가격,3,4,21,28
1272,서로,9,8,11,28
1521,신축,7,6,15,28
1576,하나요,7,8,13,28
1655,현재,6,7,14,27
1435,금고,8,2,17,27
1404,헌법소원,8,9,10,27
2350,임대,1,10,16,27
1409,성인,8,7,12,27
1760,강의,5,8,14,27
1325,전날,9,5,13,27
1750,여기,5,13,9,27
1381,친모,8,5,14,27
1578,회담,7,6,14,27
1822,남학생,5,8,14,27
1972,답변,4,9,14,27
1615,유튜브,6,10,11,27
1811,비위,5,3,19,27
1910,무마,4,13,10,27
1808,대학원생,5,6,16,27
1584,매년,7,4,16,27
1788,보관,5,4,18,27
1528,영진,7,7,13,27
1110,봉투,11,3,13,27
1631,명중,6,7,14,27
1908,공유,4,7,16,27
1539,과실,7,4,16,27
1451,참여연대,8,9,10,27
855,원전,15,6,6,27
791,미리,16,6,5,27
996,세번,13,5,8,26
1252,기승,9,4,13,26
1711,논문,6,8,12,26
1909,폭풍,4,7,15,26
1704,부천,6,10,10,26
1342,일주일,8,8,10,26
1131,포장,11,6,9,26
1096,노예,11,3,12,26
1332,보료,9,5,12,26
1960,용기,4,10,12,26
1169,절대,10,5,11,26
1687,증세,6,6,14,26
1984,김부겸,4,7,15,26
1207,동상,10,10,6,26
1215,업계,10,4,12,26
1216,실업,10,7,9,26
1756,상대로,5,2,19,26
1793,여대,5,5,16,26
1283,부분,9,4,13,26
1766,연쇄,5,5,16,26
1330,배치,9,9,8,26
1343,그날,8,8,10,26
1617,행각,6,5,15,26
2099,취한,3,3,20,26
1652,방조,6,6,14,26
2143,경력,3,9,14,26
1498,시속,7,4,15,26
1529,언론사,7,10,9,26
1685,비극,6,5,15,26
2107,학습,3,7,16,26
1403,형제,8,4,14,26
2166,제정,2,12,12,26
1558,비행기,7,5,14,26
2138,며느리,3,6,17,26
1545,정리,7,5,13,25
1483,손배,7,6,12,25
2046,취약,3,11,11,25
1002,하차,13,5,7,25
2251,도민,2,16,7,25
1033,화학,12,4,9,25
1447,검경,8,4,13,25
1069,아이돌,12,7,6,25
1587,신호,7,5,13,25
2343,선장,1,5,19,25
1424,구간,8,9,8,25
1590,번호,7,6,12,25
1855,해도,5,8,12,25
2050,보완,3,4,18,25
1746,작전,5,8,12,25
1607,할아버지,6,7,12,25
1902,익산,4,7,14,25
2352,개헌,1,16,8,25
1847,동해안,5,11,9,25
1951,갑론,4,3,18,25
1758,서울역,5,8,12,25
1832,제조,5,8,12,25
1491,시효,7,5,13,25
1149,여사,11,3,11,25
2011,약자,3,11,11,25
1764,폐업,5,5,15,25
1636,고심,6,6,13,25
1433,유리,8,6,11,25
1693,의도,6,5,14,25
924,유럽,14,6,5,25
1564,로또,7,4,14,25
1986,지법,4,10,11,25
2158,임대주택,2,6,17,25
1389,지옥,8,6,11,25
2169,역주행,2,7,16,25
2340,이주,1,11,13,25
1358,반납,8,3,14,25
1816,들통,5,2,18,25
1460,연봉,7,5,13,25
1361,승소,8,6,11,25
1886,가정폭력,4,6,15,25
1718,호기,6,6,13,25
1225,분리,10,6,9,25
2388,둔기,1,1,23,25
1818,완화,5,8,12,25
1177,가게,10,4,11,25
960,도망,14,7,4,25
967,위치,13,4,8,25
1527,여대생,7,1,17,25
1824,흡입,5,4,16,25
1623,개장,6,8,10,24
1172,세력,10,5,9,24
1649,실체,6,6,12,24
2381,총력,1,4,19,24
2363,주거,1,11,12,24
1640,사무소,6,5,13,24
1775,행패,5,1,18,24
2142,정치인,3,6,15,24
1261,공소,9,4,11,24
1162,시내,10,6,8,24
1991,메시지,4,7,13,24
1466,현수막,7,2,15,24
1482,필수,7,6,11,24
1459,웹툰,8,7,9,24
1784,결제,5,3,16,24
1976,발굴,4,9,11,24
1992,방서,4,2,18,24
1448,시계,8,8,8,24
1938,체결,4,1,19,24
1873,생존,4,7,13,24
1360,사과문,8,6,10,24
1392,탈북민,8,1,15,24
2116,지목,3,8,13,24
1337,중계,9,5,10,24
1719,강간,6,1,17,24
2059,박람회,3,11,10,24
1915,여수,4,7,13,24
2125,속옷,3,5,16,24
1729,부과,5,5,14,24
1668,파행,6,10,8,24
1732,국과수,5,4,15,24
2337,치마,1,5,18,24
1899,성과,4,6,14,24
1503,번지,7,12,5,24
2244,괴롭힘,2,5,17,24
2256,꿀꺽,2,2,20,24
2398,교도소,1,6,17,24
1657,화제,6,5,13,24
2077,스토킹,3,11,10,24
1129,미스터리,11,3,10,24
1903,소음,4,4,16,24
2082,낚시,3,6,15,24
1900,오른,4,10,10,24
1838,지난,5,6,13,24
2254,한잔,2,5,16,23
1530,시술,7,2,14,23
1891,참가,4,8,11,23
1612,묵인,6,2,15,23
1538,파리,7,6,10,23
1489,수배,7,4,12,23
1823,면죄부,5,12,6,23
1871,장례식,4,4,15,23
1867,해법,4,10,9,23
1932,고령,4,3,16,23
1970,북적,4,5,14,23
1942,발목,4,2,17,23
1947,격차,4,7,12,23
1492,후임,7,5,11,23
1833,불량,5,4,14,23
1604,방위,6,7,10,23
2093,즉각,3,8,12,23
2163,유차,2,7,14,23
1334,매장,9,5,9,23
1641,의대,6,4,13,23
2025,벤츠,3,3,17,23
1431,스마트,8,3,12,23
1301,야구,9,3,11,23
1297,복무,9,5,9,23
1654,조합원,6,9,8,23
1736,중학교,5,4,14,23
1326,아프리카,9,3,11,23
1730,탈락,5,7,11,23
1768,캠페인,5,7,11,23
2283,충남지사,2,13,8,23
1428,분야,8,2,13,23
2003,전형,3,9,11,23
1663,최선,6,2,15,23
1370,여권,8,3,12,23
2089,입법,3,7,13,23
1205,평생,10,5,8,23
2070,미흡,3,3,17,23
1979,안내,4,7,12,23
1514,통진당,7,11,4,22
2041,연령,3,3,16,22
1045,프랑스,12,4,6,22
2317,시정,1,10,11,22
1737,지구대,5,1,16,22
1682,논쟁,6,4,12,22
2239,구직,2,5,15,22
1864,임시,4,7,11,22
1371,한밤,8,3,11,22
1408,오해,8,4,10,22
2104,변명,3,2,17,22
2287,전격,2,6,14,22
1515,경위,7,6,9,22
2079,반영,3,7,12,22
1920,노모,4,1,17,22
1918,성분,4,2,16,22
2194,개설,2,8,12,22
2230,재정,2,10,10,22
923,은퇴,14,2,6,22
1709,조기,6,5,11,22
1671,불꽃,6,5,11,22
1722,면담,6,3,13,22
1721,태운,6,6,10,22
1531,체육,7,4,11,22
1430,누군가,8,2,12,22
1633,쇼핑,6,4,12,22
1776,야생,5,7,10,22
1973,자제,4,7,11,22
1829,캠퍼스,5,3,14,22
1440,무릎,8,5,9,22
1790,이중,5,8,9,22
1646,골프장,6,7,9,22
1622,촛불집회,6,5,11,22
1436,후회,8,3,11,22
1490,현역,7,6,9,22
2266,낙태죄,2,9,11,22
1220,대원,10,1,11,22
2121,난항,3,6,13,22
1598,브로커,7,1,14,22
1637,일방,6,7,9,22
1294,이해,9,4,9,22
1843,기범,5,1,16,22
1477,사생활,7,5,10,22
1809,부근,5,5,12,22
1952,활성화,4,8,10,22
1755,결의,5,5,12,22
2024,관행,3,8,11,22
1853,유도,5,3,14,22
2120,수요,3,1,18,22
2263,불신,2,5,15,22
1996,먼지,4,9,9,22
2081,정비,3,4,14,21
2331,의약품,1,2,18,21
2137,투숙,3,4,14,21
1983,꼬리,4,6,11,21
2067,소재,3,4,14,21
2039,장면,3,7,11,21
2334,주요,1,6,14,21
1988,혹시,4,3,14,21
1995,토론,4,9,8,21
2342,일정,1,6,14,21
2005,술집,3,2,16,21
2047,짝퉁,3,3,15,21
2019,수시,3,7,11,21
2021,마비,3,6,12,21
1929,한숨,4,6,11,21
2394,설계,1,10,10,21
2258,생태,2,11,8,21
1594,장병,7,7,7,21
1541,지점,7,4,10,21
1606,통행료,6,6,9,21
1767,통행,5,4,12,21
1523,불기소,7,5,9,21
1865,살이,4,9,8,21
1540,사안,7,3,11,21
1582,파출소,7,3,11,21
1849,고개,5,4,12,21
1592,금괴,7,5,9,21
1792,취준생,5,2,14,21
1438,기내,8,2,11,21
1648,출생,6,1,14,21
1681,자식,6,1,14,21
1759,회식,5,1,15,21
1698,소주,6,3,12,21
1841,정유,5,5,11,21
1710,물의,6,6,9,21
1726,단서,6,7,8,21
1470,원칙,7,5,9,21
1739,생후,5,7,9,21
1399,신속,8,5,8,21
1264,대행,9,4,8,21
1319,그냥,9,3,9,21
1890,온실가스,4,10,7,21
1773,아웃,5,8,8,21
1135,사의,11,5,5,21
1344,빈소,8,2,11,21
1794,등산,5,7,9,21
1109,손해,11,3,7,21
1274,반격,9,5,7,21
1269,행렬,9,2,10,21
1244,신발,10,1,10,21
1692,실제,6,4,10,20
1684,만료,6,3,11,20
1666,퇴사,6,1,13,20
1782,초등학생,5,7,8,20
1689,지위,6,6,8,20
1959,수사의뢰,4,3,13,20
1958,수갑,4,6,10,20
2015,남양주,3,5,12,20
2064,신규,3,5,12,20
1963,펑펑,4,4,12,20
1720,국선,6,1,13,20
2056,정신질환,3,4,13,20
1828,끼리,5,5,10,20
2042,생리대,3,6,11,20
1642,무조건,6,7,7,20
2014,당부,3,4,13,20
1525,본인,7,3,10,20
2177,한전,2,6,12,20
1450,헌금,8,5,7,20
2267,통계,2,6,12,20
1803,처방,5,6,9,20
1485,대치,7,4,9,20
1927,인식,4,3,13,20
1350,추돌사고,8,2,10,20
1499,관측,7,7,6,20
2368,감동,1,9,10,20
2150,국립공원,3,10,7,20
2034,냄새,3,3,14,20
1548,물건,7,2,11,20
1553,코레일,7,4,9,20
2155,측정,3,4,13,20
1583,임박,7,2,11,20
1291,이익,9,3,8,20
1763,차원,5,4,10,19
1749,정년,5,6,8,19
1748,구입,5,3,11,19
1771,고립,5,1,13,19
1781,존재,5,4,10,19
2030,표시,3,3,13,19
2004,질병,3,2,14,19
1621,포획,6,4,9,19
1744,구축,5,4,10,19
1476,눈치,7,4,8,19
1121,사면,11,3,5,19
2379,융합,1,12,6,19
1308,보유,9,5,5,19
1322,악마,9,3,7,19
1398,약물,8,2,9,19
2277,불응,2,5,12,19
1493,기적,7,4,8,19
1733,한국사,5,5,9,19
2186,부품,2,5,12,19
2136,당첨,3,2,14,19
1628,저수지,6,1,12,19
1686,외상,6,4,9,19
1705,제압,6,4,9,19
2060,솜방망이,3,3,13,19
1785,말다툼,5,1,13,19
1897,유입,4,6,9,19
1922,분당,4,3,12,19
1957,참가자,4,8,7,19
1844,장난,5,2,12,19
1848,이불,5,2,12,19
1946,중간,4,5,10,19
1955,고생,4,3,12,19
1939,수상한,4,6,9,19
1875,열기,4,4,11,19
1807,개시,5,9,5,19
1964,극복,4,7,8,19
1965,보강,4,4,11,19
2061,해산,3,8,7,18
1678,고기,6,4,8,18
2072,총파업,3,8,7,18
2076,황당,3,5,10,18
2078,상반기,3,3,12,18
2372,불안감,1,2,15,18
1266,대학병원,9,2,7,18
1907,한밤중,4,1,13,18
2043,전액,3,5,10,18
1827,유전자,5,2,11,18
2101,순천,3,7,8,18
2102,트라우마,3,6,9,18
2114,존중,3,7,8,18
2109,배경,3,3,12,18
2339,조형,1,6,11,18
1925,노숙인,4,4,10,18
1919,반려,4,3,11,18
1866,임용,4,3,11,18
2236,불감증,2,3,13,18
2305,하락,1,5,12,18
1354,지능,8,3,7,18
1353,워크숍,8,4,6,18
2344,취객,1,1,16,18
1676,먹이,6,2,10,18
2149,양주,3,3,12,18
1596,태아,7,2,9,18
1944,비만,4,7,7,18
1614,조선족,6,2,10,18
1945,대학원,4,4,10,18
2353,행방,1,6,11,18
2385,고공,1,9,8,18
1743,진심,5,5,8,18
1789,방식,5,8,5,18
1761,열정,5,2,11,18
1777,무관,5,2,11,18
2013,익사,3,3,12,18
2007,백신,3,4,11,18
1980,분통,4,2,12,18
1745,소문,5,2,11,18
1975,가맹,4,5,9,18
1801,금연,5,7,6,18
2315,장소,1,6,10,17
2210,로부터,2,3,12,17
2190,재발,2,7,8,17
1662,조항,6,7,4,17
1876,착용,4,3,10,17
1989,평등,4,8,5,17
1535,금감원,7,3,7,17
1804,화이트리스트,5,5,7,17
1620,다수,6,3,8,17
2228,재수,2,2,13,17
2226,폭발물,2,2,13,17
1941,중태,4,4,9,17
2084,서귀포,3,5,9,17
2085,동기,3,2,12,17
2180,콘텐츠,2,5,10,17
2017,신원,3,2,12,17
2178,실효,2,3,12,17
1851,목줄,5,2,10,17
2168,불법체류,2,1,14,17
1546,남아,7,3,7,17
1914,완료,4,4,9,17
1846,나체,5,3,9,17
2346,유인,1,2,14,17
2068,임산부,3,1,13,17
1571,중년,7,4,6,17
1882,상당,4,2,11,17
2229,교감,2,4,11,17
1653,배우자,6,5,6,17
2038,여파,3,3,11,17
1462,억원,7,3,7,17
2265,오류,2,1,14,17
1467,해운대,7,3,7,17
2282,경로,2,4,11,17
2260,그늘,2,3,12,17
1869,중앙회,4,1,12,17
1473,미제,7,1,9,17
1479,장교,7,5,5,17
2130,기한,3,2,12,17
2285,축사,2,1,14,17
2286,투기,2,3,12,17
2052,야근,3,3,11,17
1494,신한은행,7,3,7,17
1277,국가대표,9,2,6,17
1496,실시간,7,4,6,17
1723,환수,6,2,9,17
2289,은혜,1,5,11,17
1511,기증,7,1,9,17
2290,편입,1,4,12,17
2234,대폭,2,4,11,17
2354,확장,1,6,9,16
1634,주가조작,6,3,7,16
2008,가출,3,2,11,16
1298,직후,9,2,5,16
2395,이벤트,1,2,13,16
2328,등교,1,4,11,16
1567,변기,7,1,8,16
2235,기원,2,9,5,16
1923,맥주,4,1,11,16
2259,재개발,2,7,7,16
2253,수집,2,8,6,16
2248,연관,2,2,12,16
2247,성범죄자,2,4,10,16
2245,화장품,2,2,12,16
1874,소지,4,2,10,16
2323,학종,1,8,7,16
2159,쇼핑몰,2,3,11,16
2208,과연,2,6,8,16
2326,학교폭력,1,6,9,16
2203,법안,2,5,9,16
2191,처남,2,3,11,16
1916,베란다,4,4,8,16
2179,가중,2,1,13,16
2170,입찰,2,4,10,16
1658,인증샷,6,3,7,16
1632,마치,6,5,5,16
1728,인수,5,4,7,16
2066,빌라,3,2,11,16
1905,인격,4,4,8,16
2069,불공정,3,3,10,16
2088,영포,3,5,8,16
2087,기피,3,3,10,16
2048,수정,3,3,10,16
2103,사용자,3,5,8,16
2106,독립운동,3,8,5,16
1752,집안,5,1,10,16
1888,카메라,4,7,5,16
1694,이낙연,6,4,6,16
2020,데이,3,4,9,16
1706,여가부,6,3,7,16
1956,강조,4,4,8,16
1683,졸업,6,4,6,16
1690,연료,6,6,4,16
2032,회피,3,4,9,16
1725,부문,6,4,6,16
1836,낙서,5,2,9,16
2115,육박,3,7,6,16
2074,유학,3,3,10,16
2301,응시,1,4,10,15
2065,산업혁명,3,6,6,15
2291,역학,1,3,11,15
2062,설득,3,4,8,15
2026,애도,3,1,11,15
1783,이면,5,2,8,15
2232,수립,2,7,6,15
1950,자꾸,4,3,8,15
2221,보상금,2,2,11,15
1852,양보,5,3,7,15
2183,조류,2,5,8,15
2218,금은,2,2,11,15
2213,동성애,2,7,6,15
2325,하천,1,4,10,15
2195,착취,2,2,11,15
2073,청정,3,3,9,15
2333,주력,1,1,13,15
2209,실천,2,8,5,15
1931,지문,4,3,8,15
2200,공직,2,2,11,15
2201,외고,2,7,6,15
1998,출입국,4,2,9,15
1860,기분,4,1,10,15
2027,갑질,3,2,10,15
2022,조속,3,7,5,15
2112,누락,3,2,10,15
2380,표정,1,8,6,15
2366,단순,1,4,10,15
2010,보름,3,3,9,15
2031,피고,3,5,7,15
1969,미달,4,3,8,15
2262,배포,2,4,9,15
1872,양육,4,1,10,15
1625,배신,6,4,5,15
1677,가세,6,3,6,15
2141,날벼락,3,3,9,15
1825,재배,5,2,8,15
1981,총선,4,4,7,15
1904,인척,4,4,7,15
2144,충주,3,3,9,15
2146,되풀이,3,2,10,15
1993,용서,4,1,10,15
2284,완도,2,2,11,15
2151,부작용,3,2,10,15
1820,청부,5,2,8,15
2270,시공사,2,4,9,15
2036,회계,3,1,11,15
2271,리나,2,6,7,15
2057,곤란,3,2,10,15
1974,제보자,4,3,8,15
2382,발송,1,4,9,14
2273,번복,2,1,11,14
2207,번진,2,3,9,14
1701,전혀,6,3,5,14
2211,마케팅,2,7,5,14
2214,누나,2,2,10,14
2216,개교,2,5,7,14
2387,민낯,1,1,12,14
1386,탈북자,8,2,4,14
2311,실습,1,2,11,14
2386,도마,1,1,12,14
1961,푸드,4,2,8,14
1795,수치심,5,1,8,14
2054,먹튀,3,1,10,14
2055,중재,3,4,7,14
2217,봉쇄,2,2,10,14
1977,가나,4,3,7,14
2018,부순,3,2,9,14
1934,약사,4,3,7,14
2094,조사해,3,4,7,14
2160,오픈,2,3,9,14
1699,주먹,6,1,7,14
2092,파도,3,3,8,14
2341,식구,1,3,10,14
1943,태안,4,3,7,14
2171,다행,2,4,8,14
2105,매도,3,1,10,14
1765,보행,5,1,8,14
1921,외벽,4,5,5,14
2174,주가,2,4,8,14
2175,앙심,2,1,11,14
2096,치기,3,2,9,14
2176,압류,2,2,10,14
2345,악용,1,4,9,14
2086,수두,3,2,9,14
2083,졸음,3,2,9,14
2332,고작,1,1,12,14
2000,농약,4,3,7,14
1651,브랜드,6,2,6,14
2124,만족도,3,2,9,14
1674,블록,6,2,6,14
1933,점심,4,2,8,14
1999,갈수록,4,2,8,14
2355,학위,1,3,9,13
1901,토사,4,2,7,13
1911,입사,4,2,7,13
2016,살기,3,1,9,13
2279,계단,2,2,9,13
2280,친딸,2,1,10,13
2122,안성,3,4,6,13
1994,의견서,4,4,5,13
2049,불똥,3,4,6,13
2127,별거,3,2,8,13
2268,대국민,2,4,7,13
2257,집주인,2,3,8,13
1878,출입문,4,2,7,13
2391,좌절,1,4,8,13
2329,조준,1,4,8,13
1845,커뮤니티,5,3,5,13
2173,기장,2,4,7,13
2358,조물,1,3,9,13
2192,김치,2,6,5,13
2189,해지,2,4,7,13
2336,교환,1,4,8,13
2187,고속버스,2,3,8,13
1917,보조,4,5,4,13
2184,악몽,2,2,9,13
2373,시선,1,3,9,13
2035,손녀,3,3,7,13
1861,태국,4,1,8,13
1936,만기,4,2,7,13
2090,간음,3,2,8,13
1883,잔혹,4,2,7,13
2302,각종,1,3,8,12
2390,명분,1,5,6,12
2399,관람,1,6,5,12
2303,발끈,1,4,7,12
2308,마감,1,3,8,12
2310,조장,1,7,4,12
2294,멧돼지,1,4,7,12
2348,시아버지,1,1,10,12
2375,가입자,1,5,6,12
2357,갈취,1,2,9,12
2288,수령,2,3,7,12
2362,관리자,1,5,6,12
2400,기여,1,4,7,12
1675,체인,6,1,5,12
2167,소란,2,1,9,12
2071,재수감,3,4,5,12
1738,내면,5,3,4,12
2212,권익위,2,2,8,12
2206,모자,2,3,7,12
2204,비중,2,5,5,12
2080,불가능,3,3,6,12
2029,체감,3,2,7,12
2198,언어,2,3,7,12
1930,절벽,4,1,7,12
2028,특강,3,1,8,12
1978,고도,4,3,5,12
2012,상관,3,1,8,12
1982,기독교,4,3,5,12
2145,악의,3,3,6,12
2110,창의,3,4,5,12
2272,객실,2,2,8,12
2108,지기,3,2,7,12
2129,고령화,3,3,6,12
2242,술값,2,2,8,12
2243,전락,2,2,8,12
2162,바다로,2,2,8,12
1926,수제,4,2,6,12
2320,확충,1,2,8,11
2123,구비,3,1,7,11
2215,교대,2,5,4,11
1948,인연,4,1,6,11
2327,교육과정,1,5,5,11
2205,사다리,2,1,8,11
2165,공시생,2,1,8,11
2364,무전,1,2,8,11
2147,화재현장,3,1,7,11
2197,이어진,2,1,8,11
2188,구경,2,5,4,11
2361,외제차,1,2,8,11
1842,연간,5,1,5,11
2097,또래,3,1,7,11
2100,총기,3,2,6,11
1962,이념,4,1,6,11
2196,교내,2,1,8,11
2219,지갑,2,1,8,11
2002,헌법재판소,4,2,5,11
2237,사후,2,2,7,11
1805,자정,5,1,5,11
2227,절단,2,2,7,11
1815,점령,5,1,5,11
2384,역시,1,3,7,11
1896,차림,4,1,6,11
1928,한국판,4,2,5,11
2261,이내,2,3,6,11
2264,일자,2,2,7,11
2269,철저,2,1,8,11
1834,예능,5,1,5,11
1894,애견,4,1,6,11
2293,대포통장,1,2,7,10
1949,수영,4,1,5,10
2347,마중,1,4,5,10
1985,자초,4,1,5,10
2367,자도,1,3,6,10
2161,복용,2,1,7,10
2126,카지노,3,2,5,10
2238,이용자,2,2,6,10
2278,세월,2,1,7,10
2316,집착,1,2,7,10
2233,교량,2,3,5,10
2051,가위,3,1,6,10
2319,금주,1,2,7,10
2378,고함,1,2,7,10
2322,심층,1,1,8,10
2324,숨기,1,1,8,10
2223,자신감,2,2,6,10
2309,실력,1,3,6,10
2224,일해,2,3,5,10
2307,생존권,1,3,6,10
2202,강경,2,1,7,10
2193,층간소음,2,2,6,10
2335,퍼포먼스,1,3,6,10
2371,분산,1,3,6,10
2295,근본,1,3,6,10
2365,민폐,1,1,7,9
2389,신종,1,1,7,9
2044,스타벅스,3,1,5,9
2276,바닷가,2,1,6,9
2314,과열,1,3,5,9
2321,사직서,1,1,7,9
2297,협정,1,1,7,9
2298,김구,1,3,5,9
2300,막무가내,1,1,7,9
2231,홀인원,2,1,6,9
2225,홍수,2,2,5,9
2222,신념,2,1,6,9
2313,존폐,1,3,5,9
2220,냉장고,2,1,6,9
2250,칼부림,2,1,6,9
2252,딜레마,2,3,4,9
2241,이륙,2,2,5,9
2330,안장,1,2,6,9
2275,매입,2,2,5,9
2182,지망,2,2,5,9
2117,심해,3,1,5,9
2156,승강기,3,2,4,9
2154,차지,3,1,5,9
2349,후송,1,2,5,8
2292,경찰차,1,2,5,8
2393,설사,1,1,6,8
2296,애완견,1,1,6,8
2134,큰일,3,1,4,8
2299,외모,1,2,5,8
2351,포상,1,2,5,8
2306,현상,1,2,5,8
2185,파타야,2,1,5,8
2383,대포,1,1,6,8
2312,절감,1,2,5,8
2359,감봉,1,2,5,8
2181,타깃,2,1,5,8
2396,동아,1,1,6,8
2376,무관용,1,2,5,8
2045,레이저,3,1,4,8
2397,유골,1,1,5,7
2360,편법,1,1,5,7
2304,함정,1,2,4,7
2318,옹벽,1,1,5,7
2374,스크린,1,1,5,7
2338,투성이,1,1,5,7
