,단어명,정치 빈도수,경제 빈도수,사회빈도수,사설빈도수,총빈도수
0,대통령,1433,117,241,154,1945
687,삼성,15,1418,139,12,1584
515,투자,20,1159,27,14,1220
1281,전자,6,927,41,4,978
1292,금융,6,925,20,8,959
828,영업,12,894,14,3,923
31,인사,138,434,289,12,873
1,김정은,682,10,33,114,839
217,시장,44,710,43,17,814
228,사업,41,684,33,17,775
25,경제,166,489,24,67,746
193,경찰,48,17,644,24,733
446,개발,23,644,29,9,705
42,지원,118,495,78,9,700
120,검찰,65,64,550,16,695
2,남북,501,105,29,45,680
1251,증가,6,653,5,3,667
80,중국,84,459,55,55,653
2301,현대,1,627,13,2,643
48,개최,112,353,169,3,637
11,속보,225,23,375,1,624
464,국내,22,536,59,4,621
67,공개,95,373,123,17,608
2454,롯데,1,582,23,1,607
36,의혹,128,54,405,8,595
796,기술,12,533,35,10,590
87,수사,79,36,428,33,576
26,논란,162,202,198,13,575
619,산업,17,500,40,11,568
171,최고,52,396,100,14,562
3,회담,494,23,7,37,561
5,트럼프,362,96,18,68,544
690,사장,15,443,73,5,536
328,해외,31,461,26,8,526
96,조사,73,179,249,19,520
1866,서비스,2,483,28,6,519
91,최저임금,75,362,47,33,517
457,세계,23,385,76,33,517
35,우리,128,188,135,57,508
430,건설,24,457,14,7,502
2192,매출,1,487,6,1,495
237,인상,40,408,27,14,489
1724,칼럼,3,171,5,310,489
90,성장,75,374,13,23,485
586,종합,18,442,20,1,481
489,은행,21,429,15,11,476
1012,아파트,9,357,96,11,473
16,장관,197,176,61,30,464
24,드루,171,6,250,30,457
1350,감소,5,437,9,4,455
305,화폐,34,371,39,10,454
2198,대출,1,443,5,2,451
1202,금감원,7,425,7,7,446
1261,상승,6,434,2,2,444
215,뉴스,44,205,41,154,444
1940,금리,2,438,2,1,443
1197,이익,7,421,9,5,442
219,규제,42,360,15,24,441
57,미국,106,251,39,43,439
209,기자,46,99,48,245,438
447,부동산,23,398,8,4,433
304,가상,34,348,41,8,431
4,비핵화,370,6,6,45,427
213,확대,44,334,38,9,425
100,일자리,71,294,20,38,423
692,주택,15,385,12,10,422
525,거래,20,323,67,12,422
77,협력,85,298,30,7,420
108,단독,69,242,101,1,413
8,북한,270,50,41,52,413
789,규모,12,358,32,5,407
176,하나,51,259,62,35,407
500,목표,21,374,8,3,406
38,국민,125,151,70,59,405
632,공장,17,328,49,7,401
60,정책,102,192,55,51,400
306,하락,33,359,1,2,395
276,강화,36,329,23,2,390
1849,글로벌,3,371,8,6,388
6,정상회담,288,39,9,51,387
670,수출,15,355,5,9,384
192,혁신,48,299,21,15,383
7,국회,284,48,38,11,381
1873,증시,2,373,1,1,377
926,채용,10,281,78,7,376
959,게임,10,332,21,11,374
116,결정,66,231,62,14,373
440,직원,24,239,104,4,371
311,작년,33,303,33,1,370
296,공사,34,275,44,8,361
701,노조,14,228,90,28,360
723,전국,14,171,171,4,360
315,대상,33,281,37,6,357
790,공급,12,332,6,1,351
766,병원,13,193,139,3,348
14,합의,206,98,29,15,348
49,검토,112,188,37,10,347
29,문제,141,106,69,27,343
45,발언,113,55,38,135,341
1184,별세,7,31,302,1,341
423,사회,24,200,83,33,340
409,도입,25,283,21,6,335
1584,업체,4,279,45,7,335
1019,법원,9,23,296,2,330
89,위해,75,191,52,11,329
325,여성,32,68,217,9,326
816,화재,12,91,218,4,325
142,고용,57,203,41,24,325
163,추가,53,202,66,3,324
9,선언,259,28,11,25,323
210,사건,46,14,251,11,322
162,우려,53,220,34,13,320
1579,경영,4,296,14,6,320
69,발표,93,171,40,8,312
666,연속,15,276,17,2,310
13,제재,218,56,3,32,309
1835,보험,3,277,19,6,305
530,관리,20,237,37,9,303
17,한미,196,92,7,7,302
20,논의,180,95,16,10,301
1427,가구,5,268,24,3,300
732,검사,14,92,187,4,297
877,생산,11,271,9,4,295
392,재판,26,5,251,12,294
592,구속,18,32,237,4,291
285,원전,34,205,15,37,291
639,돌파,16,253,18,2,289
151,사람,55,63,89,81,288
97,소득,73,175,16,23,287
2114,가격,2,279,3,2,286
376,사고,28,120,124,13,285
293,시대,34,188,31,32,285
2195,반도체,1,262,9,11,283
56,김경수,108,1,168,6,283
222,이상,42,192,38,11,283
47,공동,112,141,24,6,283
547,사망,19,38,222,3,282
10,평양,230,11,20,19,280
155,펀드,55,218,4,2,279
41,협상,119,128,8,24,279
448,신임,23,222,30,2,277
232,개선,41,220,13,3,277
1198,네이버,7,245,21,4,277
270,지역,37,198,32,9,276
379,피해,27,132,108,8,275
2377,업계,1,261,10,2,274
2366,치료,1,232,39,2,274
50,중단,110,104,46,13,273
557,강남,19,197,54,3,273
382,전환,27,224,17,3,271
159,카드,54,185,21,11,271
2211,분양,1,265,3,2,271
37,평창,127,60,58,23,268
199,김동연,47,211,5,4,267
1332,계약,5,246,13,2,266
299,경기,34,185,39,3,261
62,위원장,100,106,44,11,261
2018,부회장,2,241,15,3,261
1619,최초,4,206,42,1,253
1426,지난해,5,243,4,1,253
1048,사상,8,201,38,6,253
12,민주당,222,5,18,8,253
533,센터,20,187,42,3,252
343,국제,30,160,56,6,252
321,일본,32,143,58,19,252
2364,진출,1,239,10,1,251
111,국가,68,104,55,22,249
865,교수,11,125,109,3,248
15,평화,200,9,15,23,247
272,정보,36,164,40,7,247
147,관련,56,134,54,2,246
411,국민연금,25,175,30,14,244
55,회의,108,87,37,11,243
676,폭행,15,12,210,6,243
1451,아이,5,71,158,9,243
583,서울시,18,135,82,8,243
544,영향,19,182,39,1,241
18,훈련,186,8,24,21,239
112,행사,68,137,28,5,238
498,압수수색,21,16,197,4,238
289,위기,34,142,36,24,236
93,가능성,74,124,35,3,236
146,확정,56,86,93,1,236
300,안전,34,150,37,12,233
1004,체결,9,218,4,1,232
1424,코리아,5,193,17,16,231
81,확인,84,83,57,7,231
66,준비,96,91,31,12,230
27,한반도,153,15,36,26,230
352,전쟁,30,147,28,24,229
28,대화,151,39,12,27,229
1536,징역,4,6,214,5,229
23,대북,176,16,8,29,229
809,자금,12,165,50,2,229
1590,수주,4,222,2,1,229
148,전문,55,98,29,46,228
84,요구,83,92,46,6,227
188,가능,49,150,27,1,227
2115,상반기,2,221,3,1,227
194,방송,48,65,97,16,226
1239,에너지,6,204,14,1,225
30,선거,139,37,23,25,224
39,방문,122,77,19,6,224
1358,주식,5,198,19,2,224
746,무역,13,194,3,13,223
243,교육,40,122,36,25,223
68,전문가,93,80,30,18,221
236,현장,40,119,52,10,221
331,기관,31,156,25,7,219
221,대책,42,132,26,18,218
499,청년,21,156,31,9,217
388,성추행,27,3,185,2,217
22,지방선거,177,16,14,9,216
760,역대,13,164,32,5,214
1613,포스코,4,197,7,6,214
191,댓글,49,19,130,16,214
1154,회사,7,169,37,1,214
242,이후,40,131,32,10,213
239,모두,40,82,82,9,213
72,반대,91,70,45,7,213
922,신청,10,108,93,1,212
40,이재명,121,1,87,1,210
459,비리,23,87,87,11,208
19,김성태,183,3,21,1,208
400,불법,26,60,111,10,207
720,문화,14,79,57,57,207
847,전망,11,185,8,3,207
85,사실,82,62,53,9,206
1931,체인,2,197,6,1,206
1930,블록,2,195,6,2,205
987,시스템,9,180,11,4,204
51,협의,110,70,21,1,202
896,재건축,11,180,8,3,202
1293,폭염,6,85,102,8,201
928,적용,10,163,25,3,201
1253,공정위,6,172,22,1,201
455,효과,23,149,18,10,200
559,베트남,19,154,23,4,200
537,대비,19,166,8,7,200
685,유럽,15,159,14,11,199
1965,외국인,2,165,25,7,199
776,미세먼지,13,72,110,4,199
309,사용,33,122,30,14,199
1131,대기업,7,170,12,10,199
58,보수,105,44,30,18,197
126,전략,62,109,12,13,196
158,완화,54,125,5,12,196
1762,구속영장,3,2,189,1,195
1200,광고,7,163,22,3,195
474,업무,22,145,26,2,195
2133,생명,2,172,17,3,194
1058,발견,8,45,136,5,194
229,계획,41,129,21,3,194
21,판문점,180,1,4,8,193
437,본격,24,152,16,1,193
201,대응,46,95,41,10,192
196,호텔,48,119,20,5,192
531,지금,20,57,96,17,190
383,운영,27,134,25,3,189
363,조선,29,137,18,5,189
169,고발,53,64,70,2,189
145,필요,56,97,29,6,188
398,국감,26,153,8,1,188
358,조작,29,48,99,10,186
982,한마디,9,7,7,162,185
487,실시,21,153,9,2,185
1309,포럼,6,129,46,1,182
99,조치,73,64,36,9,182
1106,의료,8,127,43,4,182
302,통신,34,141,3,3,181
1689,협회,3,139,38,1,181
186,시간,49,83,38,10,180
124,계속,62,61,42,14,179
182,출신,50,60,58,11,179
2380,단지,1,163,10,4,178
541,부담,19,144,14,1,178
2409,매각,1,174,1,2,178
160,책임,53,63,56,5,177
150,특별,55,73,35,13,176
843,건강,11,124,39,2,176
295,발전,34,125,16,1,176
247,인정,39,31,103,3,176
179,단체,51,40,69,15,175
230,기대,41,124,5,5,175
234,성공,41,118,12,4,175
324,안희정,32,2,135,6,175
1249,연구,6,136,30,2,174
115,통합,67,99,6,2,174
113,주도,67,80,10,17,174
697,경쟁,15,138,11,9,173
118,개혁,65,61,24,23,173
92,압박,74,67,14,18,173
1429,자율,5,162,3,3,173
449,가장,23,90,48,11,172
458,대신,23,98,36,15,172
539,최종,19,129,22,1,171
143,점검,57,98,11,4,170
46,정상,113,29,17,11,170
1941,로봇,2,156,5,6,169
95,취소,74,48,40,7,169
501,차량,21,74,67,6,168
2112,타이어,2,159,4,3,168
1229,판사,6,1,146,15,168
1134,태양광,7,129,17,14,167
141,사과,57,37,66,6,166
1044,인공,8,144,7,7,166
1272,집값,6,146,2,11,165
385,대한민국,27,73,38,27,165
1003,전기,9,136,8,11,164
1082,추석,8,115,35,6,164
527,원장,20,85,58,1,164
65,싱가포르,96,47,9,11,163
2113,환율,2,157,2,2,163
1496,활용,4,147,7,5,163
921,태풍,10,30,121,2,163
1115,거래소,8,138,16,1,163
1223,시각,6,7,2,147,162
1072,취업,8,106,38,10,162
401,평가,26,129,5,2,162
317,갈등,32,93,31,6,162
366,속도,28,119,10,4,161
1853,제품,3,148,8,1,160
444,미투,24,6,117,13,160
370,주년,28,92,32,8,160
1047,상품,8,148,3,1,160
333,선물,30,94,27,8,159
54,총리,108,28,17,6,159
394,참여,26,106,19,7,158
320,신고,32,62,55,8,157
730,인터넷,14,114,27,2,157
227,금지,41,57,47,12,157
529,가족,20,39,90,7,156
414,인도,25,104,19,8,156
1697,창업,3,135,15,3,156
2187,지능,1,140,8,6,155
975,수입,9,135,10,1,155
981,대법원,9,3,124,19,155
240,시설,40,82,23,10,155
704,자산,14,131,8,1,154
1721,자동차,3,133,12,6,154
681,최저,15,129,9,1,154
911,연금,10,110,29,5,154
1060,예상,8,123,18,4,153
955,회복,10,119,23,1,153
931,구축,10,137,5,1,153
486,유출,21,49,82,1,153
849,환경,11,98,21,23,153
195,해결,48,79,18,8,153
267,핵심,37,79,29,7,152
33,방북,134,8,2,8,152
384,유지,27,108,13,4,152
562,인천,19,70,62,1,152
658,조정,16,109,23,3,151
175,연기,51,41,54,5,151
168,결과,53,64,28,5,150
203,거부,46,13,77,14,150
32,통일부,137,1,5,7,150
119,재개,65,66,16,3,150
139,요청,58,53,30,8,149
187,위반,49,52,43,4,148
76,사퇴,86,32,23,7,148
123,보고,63,43,34,8,148
689,기준,15,99,28,5,147
429,개편,24,112,7,3,146
805,버스,12,49,79,6,146
682,수준,15,108,15,8,146
349,집중,30,94,17,5,146
1985,전기차,2,136,4,3,145
70,박원순,93,20,31,1,145
991,이사장,9,51,83,2,145
43,통일,118,6,14,6,144
593,주목,17,113,8,6,144
1034,인기,8,112,17,6,143
63,북핵,99,3,4,37,143
102,처리,70,53,16,4,143
74,폐기,89,15,6,33,143
1027,모델,9,106,22,5,142
212,폐지,45,57,30,10,142
438,이재용,24,81,36,1,142
1338,유통,5,128,7,2,142
153,통화,55,69,13,4,141
345,때문,30,69,32,10,141
1020,청구,9,22,105,5,141
59,미군,104,12,7,18,141
1929,주주,2,136,1,2,141
360,지방,29,79,25,7,140
132,철수,60,61,6,12,139
34,여야,130,4,2,3,139
1235,대형,6,105,24,4,139
929,확보,10,99,27,3,139
79,김기식,85,34,11,8,138
750,재단,13,71,53,1,138
1376,이야기,5,41,50,42,138
177,공식,51,68,16,2,137
2314,수첩,1,88,14,34,137
390,출범,26,96,13,1,136
1129,무죄,7,8,118,3,136
244,체제,40,84,4,8,136
307,활동,33,63,38,2,136
136,올림픽,59,34,28,15,136
231,모든,41,55,30,9,135
75,보도,88,9,33,5,135
1153,운용,7,125,2,1,135
1398,서울대,5,56,72,2,135
711,세금,14,64,23,34,135
105,인권,69,3,48,15,135
857,심사,11,60,62,2,135
288,전달,34,66,30,4,134
44,국방부,115,6,11,2,134
482,판결,21,20,89,4,134
200,주장,47,28,53,6,134
1259,살인,6,3,123,2,134
291,방안,34,89,7,3,133
954,도시,10,91,20,11,132
733,쇼크,14,106,10,2,132
313,공무원,33,36,51,12,132
726,주말,14,33,81,4,132
249,통해,38,70,18,6,132
699,추락,15,44,64,9,132
1874,적자,2,117,8,4,131
467,주의,22,62,34,13,131
53,군사,108,5,5,13,131
576,피해자,18,19,90,4,131
106,정권,69,13,20,29,131
1526,급증,4,109,16,2,131
292,다음,34,61,26,9,130
739,기록,13,69,43,5,130
1682,중소기업,3,121,2,3,129
64,외교,98,1,6,24,129
329,기념,31,61,34,3,129
1523,결제,4,118,5,2,129
2006,스타,2,101,23,3,129
157,예산,54,50,14,10,128
61,국방,102,7,3,16,128
456,가동,23,98,4,3,128
953,세대,10,82,27,9,128
260,나라,37,27,27,36,127
570,처벌,18,18,85,6,127
977,안정,9,110,7,1,127
966,이용,9,90,17,11,127
589,민간,18,85,20,4,127
1103,평균,8,101,15,2,126
71,조명,92,30,3,1,126
351,주민,30,33,57,6,126
483,시위,21,9,81,15,126
110,주간조선,68,11,45,1,125
647,가치,16,93,11,5,125
662,아들,16,13,91,5,125
600,걱정,17,63,29,15,124
894,부부,11,21,87,5,124
596,변경,17,95,10,1,123
322,시민,32,18,67,6,123
286,위원,34,53,33,3,123
287,교체,34,68,14,7,123
372,반발,28,59,33,3,123
109,참석,68,40,13,2,123
751,통상,13,90,11,9,123
985,개인,9,89,21,3,122
612,신설,17,98,6,1,122
347,설치,30,60,29,3,122
920,지급,10,89,21,2,122
386,감사,27,71,20,3,121
1032,폭탄,9,85,15,12,121
520,비상,20,72,27,2,121
104,입장,69,22,24,6,121
1112,사기,8,49,59,4,120
73,고위,89,12,12,7,120
1083,관세,8,110,1,1,120
1537,선고,4,3,110,2,119
180,문재인,51,26,27,15,119
1166,세상,7,67,24,21,119
839,당국,11,94,12,1,118
1946,급락,2,114,1,1,118
1545,임금,4,99,13,2,118
1740,디자인,3,58,9,48,118
52,이해찬,110,3,2,3,118
121,연합,64,35,14,5,118
1241,여행,6,82,23,7,118
181,평창올림픽,51,42,12,13,118
433,이틀,24,63,27,3,117
1257,기부,6,78,31,2,117
206,자유,46,16,32,23,117
1155,한전,7,104,2,4,117
2137,비트코인,2,99,14,2,117
569,의사,18,33,59,7,117
170,임명,52,45,15,5,117
510,기간,21,65,23,7,116
373,여부,28,43,44,1,116
1848,인천공항,3,81,31,1,116
103,석탄,70,35,1,9,115
275,수도,36,51,19,9,115
342,취임,30,66,16,3,115
365,총장,28,7,76,4,115
807,연구원,12,54,48,1,115
166,비서,53,20,41,1,115
2491,열사,1,106,7,1,115
1243,위험,6,68,33,8,115
864,제도,11,89,6,8,114
135,지사,60,10,41,3,114
983,생활,9,93,6,6,114
2249,기각,1,5,105,2,113
1026,가지,9,66,24,14,113
1297,수수료,6,102,4,1,113
1410,남성,5,24,82,2,113
391,보고서,26,77,8,2,113
183,실장,50,30,25,7,112
144,나눔,57,39,15,1,112
129,예술,61,12,28,11,112
2227,데이터,1,106,3,2,112
514,단축,21,76,10,4,111
94,안보,74,11,11,15,111
655,연장,16,80,14,1,111
602,희망,17,76,12,6,111
254,러시아,38,67,3,3,111
410,개입,25,39,41,6,111
871,전력,11,86,11,2,110
301,참가,34,70,4,2,110
879,지정,11,90,7,2,110
198,적폐,48,6,34,22,110
858,시행,11,86,9,3,109
202,생각,46,22,25,16,109
78,남북정상회담,85,13,8,2,108
803,군산,12,67,25,4,108
364,공항,29,33,41,5,108
880,어디,11,55,27,14,107
651,제한,16,66,21,4,107
152,비판,55,21,21,10,107
1569,총재,4,92,9,1,106
813,공인,12,85,4,5,106
2340,인증,1,93,10,2,106
323,비용,32,69,4,1,106
979,투입,9,74,22,1,106
684,부상,15,17,71,3,106
1456,무료,5,75,24,1,105
128,지지,61,23,14,7,105
1170,수도권,7,58,38,2,105
359,공단,29,50,25,1,105
252,포기,38,35,19,13,105
416,등장,25,55,18,7,105
626,구조,17,49,35,3,104
1370,기반,5,95,1,3,104
1540,과학,4,81,10,9,104
357,처음,29,42,27,6,104
628,공유,17,80,4,3,104
2402,근로자,1,68,33,2,104
872,뇌물,11,3,86,3,103
724,동시,14,34,8,47,103
340,간다,30,35,32,6,103
443,긴급,24,35,42,2,103
768,선택,13,50,33,7,103
1009,건물,9,29,57,8,103
473,폐쇄,22,55,17,9,103
1920,가입,2,89,10,1,102
82,특사,84,2,1,15,102
1381,감독,5,52,44,1,102
774,대회,13,53,33,3,102
1991,혜택,2,85,11,4,102
233,역사,41,14,28,19,102
1365,아시아,5,71,25,1,102
475,박근혜,22,5,69,5,101
588,집단,18,23,54,6,101
253,상황,38,46,10,7,101
154,투표,55,33,10,3,101
1881,모집,2,88,10,1,101
1709,이사,3,76,21,1,101
1592,허가,4,82,14,1,101
214,관계,44,28,20,9,101
211,하라,45,15,32,9,101
332,성과,30,62,4,5,101
164,제안,53,29,15,3,100
695,바람,15,55,20,10,100
130,수석,60,17,20,3,100
2356,대우,1,94,3,2,100
1075,전용,8,80,9,2,99
350,의심,30,30,36,3,99
677,성폭력,15,4,79,1,99
722,사태,14,61,16,8,99
2196,콘텐츠,1,94,2,2,99
1050,위원회,8,60,29,1,98
799,공모,12,56,28,2,98
591,기회,18,65,8,7,98
2079,카페,2,61,27,8,98
284,청원,35,7,53,3,98
436,완료,24,68,4,2,98
825,영화,12,43,32,11,98
940,독자,10,20,2,65,97
341,제출,30,44,22,1,97
1116,사랑,7,38,37,15,97
165,철도,53,24,9,11,97
1605,항공,4,84,7,2,97
1720,기능,3,84,9,1,97
705,고민,14,59,19,5,97
1203,다스,7,9,78,2,96
220,안해,42,27,25,2,96
465,도전,22,52,15,7,96
83,개헌안,84,2,2,8,96
251,과거,38,16,29,13,96
656,기사,16,28,49,3,96
598,나선,17,58,15,5,95
1167,거리,7,54,22,12,95
563,다른,18,30,29,18,95
1556,장기,4,69,17,5,95
1723,몰카,3,1,86,5,95
445,적극,23,53,15,4,95
1331,현금,5,73,13,3,94
978,진화,9,47,35,3,94
1226,절반,6,70,14,4,94
488,축소,21,54,14,5,94
101,실무,71,16,3,4,94
882,장사,11,68,8,7,94
184,언론,50,8,22,13,93
772,아내,13,3,74,3,93
172,파견,52,22,17,2,93
1217,기재부,6,85,1,1,93
2416,가스,1,75,16,1,93
127,공연,61,8,17,6,92
935,인력,10,73,8,1,92
273,실패,36,28,14,14,92
1771,식품,3,77,10,2,92
1421,남편,5,6,76,5,92
189,유해,49,14,25,4,92
668,서도,15,44,28,5,92
526,분리,20,60,10,2,92
693,보유,15,64,9,4,92
88,종전,77,3,2,10,92
567,운동,18,22,40,12,92
933,의무,10,59,17,5,91
717,조직,14,57,17,3,91
86,지지율,81,3,1,6,91
407,선수,26,16,40,9,91
491,세월호,21,1,61,7,90
646,시험,16,42,28,4,90
577,교통,18,45,24,3,90
399,가짜,26,20,28,16,90
281,지시,35,12,34,8,89
125,시진핑,62,8,3,16,89
1541,실종,4,8,73,4,89
1949,교사,2,2,82,3,89
2368,리스크,1,81,4,3,89
1017,지진,9,36,41,3,89
948,원인,10,55,21,3,89
764,간부,13,9,62,4,88
435,한국인,24,30,32,2,88
709,민노총,14,11,52,11,88
248,노력,39,33,15,1,88
439,차례,24,17,42,5,88
998,확산,9,47,27,5,88
161,대사,53,8,21,6,88
355,단계,29,44,12,3,88
425,경고,24,34,21,9,88
664,관심,16,53,11,8,88
338,개정,30,49,3,6,88
2253,복합,1,83,2,1,87
257,권력,38,3,25,21,87
1491,독일,4,62,15,6,87
389,강제,26,9,49,3,87
122,언급,64,10,4,9,87
1894,노인,2,30,42,13,87
900,지구,11,67,6,3,87
294,소통,34,39,7,6,86
395,충돌,26,19,37,4,86
1299,근로시간,6,69,7,4,86
264,국정,37,5,37,7,86
878,집회,11,8,66,1,86
2434,아빠,1,12,72,1,86
245,유세,40,43,1,2,86
606,징계,17,30,38,1,86
808,인터뷰,12,52,20,2,86
380,현실,27,44,6,9,86
895,가슴,11,9,18,48,86
178,환영,51,25,8,2,86
173,접촉,52,8,22,3,85
609,공공기관,17,55,7,6,85
1936,고속도로,2,31,50,2,85
630,부인,17,12,54,2,85
396,먼저,26,22,21,16,85
759,총수,13,58,11,3,85
204,차관,46,22,16,1,85
729,발굴,14,36,4,31,85
406,중앙,26,26,32,1,85
914,공원,10,34,36,5,85
1302,여름,6,55,17,7,85
1714,발생,3,48,32,2,85
271,통과,37,41,5,1,84
484,도로,21,29,28,6,84
1403,대학,5,38,31,10,84
98,임종석,73,2,5,4,84
802,보상,12,56,12,4,84
605,보장,17,54,10,3,84
610,제외,17,57,8,2,84
749,붕괴,13,40,25,6,84
678,휴가,15,46,18,5,84
1187,증거,7,7,66,4,84
1698,수술,3,39,41,1,84
521,자리,20,37,18,8,83
910,기금,10,66,5,2,83
405,보복,26,28,21,8,83
827,업자,12,57,9,5,83
2124,발행,2,75,5,1,83
415,첫날,25,46,11,1,83
471,내부,22,43,15,3,83
1175,학생,7,18,49,9,83
694,우선,15,53,12,3,83
811,이제,12,32,19,20,83
848,악화,11,60,8,4,83
2490,투자자,1,72,9,1,83
420,이전,25,47,6,5,83
611,설명,17,55,7,4,83
812,소상,12,64,1,5,82
1087,도심,8,34,34,6,82
393,돌입,26,48,7,1,82
579,자료,18,40,23,1,82
319,위협,32,25,13,12,82
1268,드론,6,66,7,3,82
2237,리포트,1,14,4,63,82
874,분야,11,61,8,2,82
638,재정,16,62,2,2,82
969,코드,9,54,12,6,81
310,사드,33,33,10,5,81
432,관광,24,44,8,5,81
114,유엔,67,4,6,4,81
452,변화,23,49,6,3,81
546,선박,19,52,8,2,81
617,이름,17,28,23,13,81
134,동참,60,14,6,1,81
618,예고,17,41,20,3,81
156,현송월,55,3,15,8,81
1897,퇴직,2,63,13,2,80
1031,미니,9,65,5,1,80
137,민주,59,7,9,5,80
2393,신라,1,69,2,8,80
1821,스포츠,3,57,17,3,80
1892,어린이,2,58,16,3,79
274,무산,36,25,15,3,79
1953,자연,2,14,14,49,79
850,근로,11,46,18,4,79
259,검증,37,28,11,3,79
490,워싱턴,21,7,3,48,79
2266,택배,1,45,31,2,79
2338,해양,1,64,11,3,79
742,복지,13,38,22,5,78
1484,경쟁력,4,70,3,1,78
956,후원,10,50,16,2,78
1444,페이스북,5,66,6,1,78
1775,학교,3,17,46,12,78
2414,체험,1,68,8,1,78
1904,보증,2,74,1,1,78
994,난민,9,1,61,7,78
675,차기,15,53,6,3,77
679,부족,15,46,12,4,77
755,유치원,13,5,51,8,77
2045,인프라,2,71,1,3,77
801,절차,12,46,15,4,77
336,의장,30,29,17,1,77
614,최악,17,37,7,16,77
374,역할,28,38,10,1,77
1449,가을,5,34,28,10,77
1001,본부,9,61,5,1,76
584,시도,18,24,30,4,76
783,작업,12,29,33,2,76
535,청탁,20,4,49,3,76
837,석방,12,6,57,1,76
367,전면,28,39,7,2,76
117,김여정,66,1,3,6,76
140,연락,58,1,16,1,76
441,홍보,24,33,13,5,75
381,유력,27,35,11,2,75
1021,본부장,9,61,3,2,75
1102,방지,8,58,7,2,75
1041,포항,8,19,46,2,75
2500,리더,1,60,9,5,75
453,판단,23,25,25,2,75
1510,맞춤,4,62,8,1,75
1465,이벤트,5,62,1,7,75
1079,인재,8,53,8,5,74
263,공세,37,30,1,6,74
205,의지,46,18,5,5,74
107,정의용,69,1,1,2,73
1037,동결,8,54,9,2,73
852,활성화,11,55,4,3,73
511,진실,21,14,31,7,73
223,탈북,42,3,22,6,73
761,새벽,13,13,44,3,73
494,조건,21,41,3,8,73
256,청산,38,12,9,14,73
250,동맹,38,14,4,17,73
753,허용,13,46,12,2,73
1135,사법,7,3,59,4,73
1285,해소,6,49,16,2,73
571,자문,18,38,15,1,72
873,마을,11,32,25,4,72
476,허위,22,16,31,3,72
1077,얼굴,8,31,25,8,72
719,재산,14,17,39,2,72
548,마음,19,13,30,10,72
725,밀양,14,5,50,3,72
573,사단,18,6,47,1,72
208,여당,46,6,7,13,72
1479,엄마,4,8,58,2,72
1731,메르스,3,21,47,1,72
131,야당,60,2,1,9,72
1069,대법관,8,1,57,5,71
1128,배상,7,13,49,2,71
190,후보자,49,17,4,1,71
1024,부실,9,44,11,7,71
1655,저격,3,3,2,63,71
297,초청,34,27,8,2,71
700,김부선,15,1,54,1,71
149,장하,55,8,4,4,71
2503,대우조선,1,64,4,2,71
1377,파리,5,57,7,2,71
133,비준,60,2,1,8,71
1694,우정,3,6,2,60,71
2130,월드,2,59,9,1,71
261,동의,37,13,14,7,71
477,신뢰,22,36,10,2,70
1921,요금,2,55,9,4,70
1557,운전,4,27,30,9,70
523,해상,20,28,21,1,70
1039,폭로,8,3,57,2,70
875,등록,11,51,7,1,70
906,누가,11,31,14,14,70
934,동반,10,47,10,3,70
946,포인트,10,53,5,2,70
1161,처분,7,40,22,1,70
2501,실형,1,2,66,1,70
375,사전,28,32,7,2,69
185,송영,50,15,3,1,69
348,종료,30,33,5,1,69
738,진짜,13,23,20,13,69
279,약속,36,12,9,12,69
794,여의도,12,44,12,1,69
710,목소리,14,38,11,6,69
2012,엔진,2,64,1,2,69
1701,세트,3,60,4,2,69
899,중심,11,48,5,4,68
431,공격,24,26,10,8,68
1418,대란,5,45,16,2,68
2264,물질,1,53,12,2,68
1538,축제,4,34,25,5,68
748,과제,13,51,2,2,68
1517,정규직,4,43,17,4,68
1501,프로젝트,4,60,3,1,68
2019,지하철,2,23,39,4,68
339,강조,30,29,4,5,68
2032,플라스틱,2,29,32,5,68
2098,배달,2,49,15,2,68
2058,치매,2,36,25,5,68
480,해임,21,24,21,1,67
283,대선,35,4,21,7,67
1552,육성,4,60,2,1,67
1776,가정,3,55,5,4,67
1015,자영,9,50,5,3,67
1252,하늘,6,16,36,9,67
1436,부자,5,42,16,4,67
371,철회,28,33,4,2,67
1214,근무,6,43,16,2,67
1565,운행,4,33,28,2,67
298,수용,34,20,10,3,67
397,뉴욕,26,27,11,3,67
1790,동남아,3,55,6,2,66
1414,월드컵,5,36,17,8,66
777,개방,12,32,16,6,66
1974,파크,2,60,3,1,66
817,참사,12,15,26,13,66
1533,자녀,4,38,23,1,66
1525,보호,4,43,13,6,66
820,자체,12,48,5,1,66
669,공작,15,2,44,5,66
1143,연구소,7,44,14,1,66
412,겨냥,25,32,6,3,66
901,범죄,11,6,44,4,65
138,일화,59,1,1,4,65
1086,장애인,8,24,31,2,65
1568,심리,4,54,6,1,65
1442,남자,5,11,43,6,65
560,대한,19,20,7,19,65
1988,국산,2,55,5,3,65
1797,명예,3,18,41,3,65
645,방식,16,38,5,6,65
278,질문,36,9,16,3,64
2083,행복,2,31,18,13,64
1784,피의자,3,2,58,1,64
174,서울시장,52,6,5,1,64
909,일제,10,40,10,4,64
1440,불안,5,42,15,2,64
1002,사임,9,39,13,3,64
555,한번,19,29,13,3,64
1439,바로,5,38,14,7,64
167,사무소,53,4,6,1,64
1425,장애,5,32,26,1,64
624,동원,17,36,10,1,64
1225,외부,6,40,15,2,63
507,타고,21,24,16,2,63
246,공약,40,5,8,10,63
1065,개막,8,45,8,2,63
1303,예방,6,35,14,8,63
1727,대학생,3,33,25,2,63
2064,어린이집,2,21,39,1,63
461,제기,23,22,15,3,63
2499,김상조,1,58,2,2,63
1494,청소년,4,32,20,7,63
532,중요,20,30,12,1,63
885,오른,11,47,4,1,63
1918,지문,2,11,4,46,63
1864,구매,2,58,2,1,63
860,광화문,11,25,24,3,63
703,마무리,14,36,12,1,63
971,휴대폰,9,37,14,3,63
1840,결혼,3,10,45,5,63
625,싸움,17,23,16,6,62
2037,나무,2,37,14,9,62
2507,케어,1,48,11,2,62
1334,노선,5,49,7,1,62
1732,음성,3,42,16,1,62
1550,차별,4,32,23,3,62
2255,충전,1,53,5,3,62
1404,카메라,5,50,4,3,62
1374,접수,5,49,7,1,62
2182,차세대,1,59,1,1,62
1818,커피,3,42,13,4,62
2090,파업,2,48,9,3,62
984,농단,9,2,48,3,62
1212,눈물,6,15,35,6,62
1305,행정,6,21,34,1,62
623,원금,17,25,17,3,62
404,상임,26,25,10,1,62
1656,아동,3,32,26,1,62
505,감축,21,30,7,4,62
1591,부활,4,46,6,5,61
1472,아트,5,9,2,45,61
1146,기존,7,52,1,1,61
1023,전체,9,39,10,3,61
2042,에어컨,2,45,13,1,61
965,정체,9,14,36,2,61
1558,파트너,4,47,8,2,61
686,무슨,15,18,20,8,61
255,법안,38,20,2,1,61
785,사이,12,19,24,5,60
1910,정비,2,53,3,2,60
1323,여자,6,12,37,5,60
1234,정지,6,35,18,1,60
344,내용,30,19,8,3,60
1753,암호,3,48,8,1,60
2373,패션,1,52,6,1,60
1068,프랑스,8,33,12,7,60
1260,공정,6,36,13,5,60
207,아베,46,10,1,3,60
580,통계,18,27,2,13,60
1524,조선일보,4,15,8,33,60
898,성희롱,11,4,43,2,60
421,깜짝,25,24,8,2,59
855,해킹,11,39,7,2,59
1173,가방,7,41,10,1,59
917,줄줄이,10,28,16,5,59
1216,한강,6,15,35,3,59
1018,이명박,9,2,46,2,59
806,재계,12,40,6,1,59
266,위안부,37,1,18,3,59
1094,긍정,8,45,1,5,59
1758,변신,3,46,7,3,59
1673,침대,3,29,22,4,58
1419,개국,5,49,3,1,58
308,유감,33,11,11,3,58
599,타결,17,37,3,1,58
508,이동,21,25,10,2,58
509,생중계,21,15,21,1,58
1043,대규모,8,41,6,3,58
564,잘못,18,17,19,4,58
1955,주문,2,47,5,3,57
1122,노동,7,34,11,5,57
334,세력,30,12,10,5,57
853,단속,11,21,15,10,57
863,까닭,11,15,24,7,57
356,얘기,29,9,14,5,57
428,침묵,24,4,15,14,57
543,자기,19,15,13,10,57
216,만찬,44,5,7,1,57
1008,전원,9,25,20,3,57
1264,대체,6,40,9,2,57
781,협박,12,4,37,4,57
1570,건가,4,8,5,39,56
1247,인간,6,23,12,15,56
1879,라돈,2,27,26,1,56
950,식당,10,18,19,9,56
197,열병,48,1,1,6,56
1887,연봉,2,44,7,3,56
235,종업원,41,2,9,4,56
1295,인식,6,39,4,6,55
804,진입,12,34,8,1,55
1786,과세,3,50,1,1,55
1267,음주,6,6,36,7,55
915,친구,10,6,33,6,55
797,전화,12,24,15,4,55
795,병역,12,1,31,11,55
1369,대치,5,42,7,1,55
262,이행,37,13,3,2,55
2438,비즈니스,1,51,2,1,55
2159,첨단,1,48,3,3,55
1383,벤츠,5,46,3,1,55
226,미사일,41,4,2,8,55
218,장성,43,6,4,2,55
1157,소리,7,24,19,5,55
1098,주인,8,17,26,4,55
841,정기,11,33,9,1,54
1211,복지부,6,33,12,3,54
1641,고용부,4,32,14,4,54
2207,박람회,1,49,3,1,54
1851,실명,3,34,16,1,54
497,찬성,21,26,4,3,54
1073,폭발,8,14,30,2,54
2100,계좌,2,42,9,1,54
426,완전,24,22,5,3,54
762,기초,13,25,14,2,54
2048,인구,2,38,13,1,54
2101,아침,2,9,35,8,54
642,유족,16,1,34,3,54
258,백악관,38,3,5,8,54
224,상봉,42,2,5,5,54
1712,급여,3,38,12,1,54
265,연설,37,8,4,5,54
1623,기고,4,10,5,35,54
671,부총리,15,31,4,3,53
2106,탈출,2,23,22,6,53
327,해체,31,10,10,2,53
1610,확장,4,47,1,1,53
644,주기,16,14,19,4,53
522,고려,20,23,9,1,53
818,사흘,12,33,6,2,53
408,호소,26,11,11,5,53
622,부정,17,22,11,3,53
1033,유튜브,8,35,6,4,53
269,이산가족,37,5,3,8,53
225,송환,42,2,6,3,53
1480,폭력,4,4,35,10,53
1457,블랙리스트,5,7,33,8,53
951,운명,10,27,8,7,52
1802,제로,3,40,7,2,52
1519,인생,4,12,27,9,52
485,정신,21,12,10,9,52
1349,공포,5,36,8,3,52
454,사찰,23,1,25,3,52
854,머리,11,17,23,1,52
434,행동,24,19,8,1,52
280,비난,35,1,12,4,52
1322,명품,6,37,8,1,52
1150,월급,7,25,12,8,52
241,발의,40,9,2,1,52
1687,외국,3,38,7,4,52
2281,상생,1,48,1,1,51
495,행위,21,18,11,1,51
326,강행,31,10,5,5,51
552,보좌,19,6,25,1,51
756,답변,13,33,4,1,51
479,합동,22,9,18,2,51
1793,미디어,3,43,4,1,51
574,시기,18,27,4,2,51
2260,도약,1,48,1,1,51
1278,상의,6,40,4,1,51
561,연루,19,14,17,1,51
640,신문,16,11,19,4,50
1120,문자,7,23,17,3,50
1084,필리핀,8,22,19,1,50
688,해제,15,28,3,4,50
1434,충격,5,29,11,5,50
636,비밀,16,18,7,9,50
1126,수당,7,14,24,5,50
1686,정민,3,1,2,44,50
635,중간,16,26,4,4,50
889,언제,11,20,8,11,50
1185,키즈,7,33,9,1,50
314,취재,33,2,12,3,50
887,상대,11,17,21,1,50
2383,영국,1,37,7,5,50
1312,차이,6,30,7,7,50
2401,식이,1,1,6,42,50
337,방위,30,13,6,1,50
1854,할머니,3,3,37,7,50
354,의미,29,9,8,4,50
757,배제,13,22,11,4,50
840,감시,11,28,9,2,50
413,직전,25,9,11,4,49
859,강도,11,13,24,1,49
2191,호기,1,40,6,2,49
290,여사,34,1,11,3,49
641,여론,16,7,14,12,49
536,배치,19,18,9,3,49
2099,그린,2,40,5,2,49
303,당선,34,7,7,1,49
463,기지,22,16,8,3,49
1992,주의보,2,27,18,2,49
727,편지,14,4,18,13,49
238,금강산,40,3,3,3,49
707,도움,14,20,13,2,49
747,이란,13,32,1,3,49
353,대변인,29,9,1,9,48
1470,반영,5,38,3,2,48
1469,레드,5,39,3,1,48
1402,음악,5,23,11,9,48
460,해명,23,7,15,3,48
575,협조,18,14,15,1,48
1220,대폭,6,37,2,3,48
1119,아버지,7,8,28,5,48
2475,신생아,1,15,31,1,48
268,서해,37,1,9,1,48
361,공조,29,15,1,3,48
2295,열풍,1,37,6,4,48
1635,교통사고,4,2,40,2,48
680,지자체,15,21,10,2,48
1067,제대로,8,19,12,9,48
2107,마스크,2,19,26,1,48
1730,출산,3,9,32,4,48
1096,보물,8,10,26,4,48
607,간담,17,26,3,1,47
2248,남용,1,6,37,3,47
691,수장,15,23,7,2,47
601,지휘,17,4,25,1,47
566,불가,18,21,7,1,47
1958,아프리카,2,35,9,1,47
702,폭풍,14,26,4,3,47
1280,예측,6,36,3,2,47
450,특위,23,22,1,1,47
2117,바다,2,22,15,8,47
788,의식,12,11,20,4,47
2033,호주,2,39,5,1,47
1156,대로,7,31,5,4,47
542,전날,19,17,9,2,47
403,만남,26,16,4,1,47
378,단일,28,11,7,1,47
1634,사우디,4,37,4,2,47
2239,형사,1,14,30,2,47
1144,직무,7,24,13,2,46
1535,망치,4,31,10,1,46
1165,양산,7,35,1,3,46
2430,이혼,1,5,37,3,46
923,눈치,10,26,7,3,46
1446,은퇴,5,26,14,1,46
786,원칙,12,18,7,9,46
1880,매년,2,36,7,1,46
1583,축구,4,16,23,3,46
960,사례,10,27,7,2,46
1071,특혜,8,8,29,1,46
2015,전담,2,24,18,2,46
1053,대부분,8,11,26,1,46
468,부대,22,11,9,4,46
2229,마당,1,7,5,33,46
787,지도,12,20,10,3,45
2131,행차,2,39,1,3,45
282,남북관계,35,8,1,1,45
2069,감정,2,29,13,1,45
335,채택,30,12,1,2,45
418,동행,25,14,5,1,45
1056,역량,8,31,4,2,45
368,여권,28,5,8,4,45
674,파악,15,20,9,1,45
633,스캔들,17,6,21,1,45
1463,쓰레기,5,12,22,6,45
631,청장,17,4,22,2,45
706,태극기,14,1,23,7,45
1505,요즘,4,27,13,1,45
1509,연말,4,36,4,1,45
556,삭제,19,11,13,2,45
997,방향,9,24,11,1,45
594,철거,17,3,24,1,45
905,과정,11,20,9,4,44
663,출동,16,14,13,1,44
884,발목,11,27,4,2,44
1794,임대료,3,34,5,2,44
2492,부모,1,12,29,2,44
316,펜스,32,1,8,3,44
1460,집행,5,18,19,2,44
2164,기계,1,40,1,2,44
1766,행진,3,36,4,1,44
924,실험,10,21,8,5,44
2129,음식,2,29,9,4,44
752,제거,13,21,9,1,44
2496,중동,1,31,5,7,44
1737,편입,3,39,1,1,44
1384,상공,5,32,5,2,44
402,막판,26,16,1,1,44
1393,손해,5,27,11,1,44
835,변수,12,29,1,1,43
810,하자,12,18,10,3,43
867,자격,11,19,10,3,43
1317,전통,6,29,6,2,43
660,명단,16,11,13,3,43
1310,주력,6,32,1,4,43
654,복구,16,21,5,1,43
417,일방,25,8,6,4,43
1937,폭우,2,3,35,3,43
277,노무현,36,1,3,3,43
1827,재활용,3,18,21,1,43
1045,스스로,8,18,14,3,43
930,통제,10,21,11,1,43
1531,차단,4,35,3,1,43
2297,태국,1,37,4,1,43
565,강력,18,12,12,1,43
492,진보,21,5,11,6,43
1010,다리,9,12,17,5,43
462,의문,23,12,7,1,43
996,훈장,9,8,22,4,43
1127,심의,7,21,13,2,43
715,캠프,14,22,6,1,43
1093,정말,8,13,10,12,43
1620,방법,4,26,7,5,42
1014,재난,9,27,3,3,42
362,승리,29,10,2,1,42
1586,전선,4,34,1,3,42
470,토론,22,13,4,3,42
502,시민단체,21,8,9,4,42
451,냉면,23,6,7,6,42
1521,강요,4,5,31,2,42
2382,실리콘밸리,1,32,3,6,42
1089,최강,8,15,18,1,42
2201,알바,1,23,14,4,42
478,생일,22,4,14,2,42
1539,사이트,4,17,20,1,42
1080,규명,8,19,13,2,42
2110,배출,2,26,10,4,42
427,정치권,24,7,9,2,42
2163,지점,1,33,7,1,42
1326,출연,5,16,20,1,42
422,선발,25,10,4,3,42
1563,매일,4,21,13,4,42
387,반입,27,6,8,1,42
1654,수퍼,3,25,10,3,41
1485,과장,4,20,14,3,41
2118,재무,2,36,2,1,41
1612,대리,4,22,14,1,41
1650,저출산,3,15,20,3,41
1633,표준,4,30,5,2,41
1914,지식,2,34,3,2,41
1416,양극화,5,32,1,3,41
1528,주변,4,27,9,1,41
1903,원자력,2,19,12,8,41
1396,전기요금,5,33,2,1,41
2022,주거,2,36,1,2,41
1379,교육부,5,7,15,14,41
1977,소방관,2,5,32,2,41
1361,공기업,5,24,3,9,41
1951,소주,2,32,6,1,41
1923,화장실,2,5,32,2,41
2141,마리,1,11,28,1,41
1255,체계,6,31,1,3,41
1059,방치,8,8,17,8,41
897,대결,11,22,6,2,41
913,상태,10,9,19,3,41
312,장소,33,5,1,2,41
603,항의,17,4,19,1,41
834,측근,12,4,23,2,41
604,민주주의,17,1,14,9,41
1057,관광객,8,20,10,2,40
728,우린,14,9,10,7,40
1593,준공,4,34,1,1,40
346,이방,30,4,2,4,40
419,경호,25,1,7,7,40
2073,코스,2,28,7,3,40
952,죽음,10,3,19,8,40
538,결의,19,15,5,1,40
861,위로,11,22,6,1,40
318,총선,32,1,4,3,40
2127,사망자,2,6,31,1,40
743,연일,13,22,3,2,40
1435,동안,5,18,15,2,40
845,긴장,11,22,5,2,40
585,다음주,18,11,10,1,40
1455,투기,5,30,2,3,40
763,입국,13,14,11,1,39
1313,탄생,6,17,11,5,39
1182,지난달,7,30,1,1,39
1356,침해,5,12,20,2,39
1400,용기,5,25,4,5,39
1177,순간,7,8,19,5,39
1373,소동,5,4,21,9,39
657,무기,16,11,7,5,39
516,의결,20,15,3,1,39
814,불만,12,19,7,1,39
1574,해고,4,16,15,4,39
1428,열기,5,28,4,2,39
1506,혁명,4,19,6,10,39
1092,그대로,8,18,11,2,39
1104,실수,8,14,14,3,39
1475,사무실,4,20,14,1,39
1291,전직,6,6,24,3,39
554,최선,19,12,6,2,39
330,심재철,31,2,4,2,39
1283,혼란,6,21,8,4,39
846,파괴,11,18,5,5,39
1876,인건비,2,30,5,2,39
1265,쟁점,6,23,9,1,39
876,경력,11,21,3,4,39
734,임기,14,12,8,4,38
1508,성범죄,4,4,28,2,38
1328,당신,5,18,10,5,38
947,완성,10,23,3,2,38
976,정도,9,16,12,1,38
1947,독점,2,31,4,1,38
2447,이건희,1,24,12,1,38
862,반복,11,15,6,6,38
424,작전,24,3,5,6,38
963,새해,10,19,4,5,38
782,노동자,12,6,19,1,38
1725,투명,3,31,3,1,38
714,이해,14,12,9,3,38
1825,구본무,3,26,7,2,38
888,투쟁,11,18,5,4,38
949,산책,10,2,5,21,38
1142,방어,7,19,6,5,37
716,상징,14,11,7,5,37
1030,제천,9,2,24,2,37
1339,극복,5,26,4,2,37
1907,편의,2,26,6,3,37
2396,담배,1,19,11,6,37
2065,공짜,2,17,11,7,37
758,제시,13,21,2,1,37
496,탈북자,21,2,8,6,37
1227,혼자,6,10,17,4,37
369,거론,28,4,3,2,37
1178,맞이,7,26,3,1,37
791,정면,12,13,11,1,37
780,헬기,12,10,13,2,37
1789,중국인,3,14,15,5,37
1210,방탄소년단,6,19,10,2,37
597,기자회견,17,1,18,1,37
1967,우주,2,28,5,2,37
1733,판정,3,16,16,2,37
551,연대,19,9,7,2,37
893,거짓말,11,4,11,10,36
1616,린다,4,22,9,1,36
377,여론조사,28,2,2,4,36
815,사정,12,16,7,1,36
2347,아카데미,1,29,5,1,36
503,관람,21,11,1,3,36
2288,시인,1,2,29,4,36
2387,불공정,1,30,3,2,36
1582,동료,4,2,28,2,36
2379,전자담배,1,26,7,2,36
1114,차원,8,21,5,2,36
1787,포장,3,15,11,7,36
648,절대,16,5,10,5,36
2270,합작,1,32,2,1,36
2509,비정규직,1,25,8,2,36
629,표명,17,9,9,1,36
838,강릉,12,13,10,1,36
1408,크게,5,27,2,2,36
587,부처,18,12,1,5,36
1722,명절,3,22,9,2,36
765,발사,13,20,2,1,36
1189,방산,7,23,4,2,36
1125,경험,7,21,7,1,36
1576,소방,4,6,25,1,36
2200,효율,1,32,2,1,36
1438,석유,5,27,3,1,36
549,시사,19,7,8,1,35
1070,방침,8,11,14,2,35
1560,계산,4,26,2,3,35
1036,기구,8,17,9,1,35
1594,자살,4,5,23,3,35
1109,순위,8,22,4,1,35
550,매우,19,2,12,2,35
1149,무상,7,21,6,1,35
1572,형제,4,22,8,1,35
2213,상한,1,31,2,1,35
2094,그림,2,18,13,2,35
672,리스트,15,13,4,3,35
1751,돼지,3,16,14,2,35
1336,제동,5,19,8,3,35
2031,아이돌,2,18,12,3,35
731,현재,14,13,6,2,35
967,리더십,9,12,3,11,35
2457,무더기,1,13,20,1,35
1889,실태,2,25,6,1,34
472,국군,22,3,2,7,34
1016,가면,9,7,11,7,34
1578,나이,4,14,13,3,34
1577,이미지,4,24,3,3,34
1401,프레,5,19,9,1,34
528,독도,20,3,8,3,34
819,초대,12,16,5,1,34
1411,높이,5,20,8,1,34
615,입법,17,13,3,1,34
1809,역전,3,26,2,3,34
1298,권리,6,12,11,5,34
2030,초반,2,30,1,1,34
754,낙하산,13,12,4,5,34
829,응원,12,7,12,3,34
1076,최근,8,19,4,3,34
2000,파워,2,27,3,2,34
1901,조합,2,26,4,2,34
466,청문회,22,7,3,2,34
2399,기억,1,10,19,4,34
1367,상처,5,9,17,3,34
1224,영어,6,12,9,7,34
1362,보완,5,25,3,1,34
999,구멍,9,15,8,2,34
718,공감,14,11,6,3,34
1319,대기,6,17,9,1,33
833,자제,12,14,4,3,33
890,더니,11,4,15,3,33
572,체육,18,6,7,2,33
2354,실업률,1,27,2,3,33
1133,앞서,7,15,5,6,33
1527,담당,4,17,7,5,33
2233,자원,1,24,6,2,33
1196,파기,7,1,24,1,33
1372,아래,5,7,14,7,33
986,사자,9,17,6,1,33
568,표현,18,4,10,1,33
1564,대가,4,8,16,5,33
939,팩트,10,9,13,1,33
961,노래,10,6,13,4,33
1108,기적,8,9,7,9,33
1011,비행기,9,13,7,4,33
1022,반성,9,5,15,4,33
1162,실질,7,8,15,3,33
513,선수단,21,6,5,1,33
627,위장,17,7,7,2,33
2476,감염,1,18,13,1,33
736,출국,13,8,10,2,33
1158,경계,7,20,1,5,33
578,협정,18,13,1,1,33
1823,예약,3,26,3,1,33
643,주자,16,13,3,1,33
1042,일단,8,11,10,3,32
540,선전,19,7,2,4,32
481,경질,21,7,1,3,32
1982,재벌,2,17,9,4,32
773,왜곡,13,5,9,5,32
886,진상,11,1,17,3,32
2335,무더위,1,6,24,1,32
2122,청소,2,21,8,1,32
964,수정,9,19,3,1,32
968,타격,9,21,1,1,32
903,가나,11,13,4,4,32
1852,손님,3,16,10,3,32
1233,시급,6,20,3,3,32
1830,의자,3,20,6,3,32
1814,강인,3,1,1,27,32
2108,유령,2,22,7,1,32
902,파문,11,4,14,3,32
1389,고문,5,12,13,2,32
1324,기름,6,14,10,2,32
1174,대장,7,10,13,2,32
972,장악,9,14,6,3,32
1555,드라마,4,13,12,3,32
1566,정현,4,9,13,6,32
851,꼼수,11,15,3,2,31
558,백두산,19,7,3,2,31
907,욕설,11,3,16,1,31
2125,안내,2,21,4,4,31
2169,이탈리아,1,22,7,1,31
1770,운반,3,22,5,1,31
2244,양성,1,25,3,2,31
2001,산다,2,21,3,5,31
927,수습,10,11,9,1,31
683,베이징,15,13,1,2,31
992,무시,9,8,11,3,31
1608,신호,4,17,7,3,31
553,심판,19,3,8,1,31
1905,지표,2,26,1,2,31
2057,공부,2,10,15,4,31
637,지적,16,8,6,1,31
2076,봇물,2,20,8,1,31
737,계기,13,8,3,7,31
620,마치,17,7,6,1,31
1304,추모,6,4,20,1,31
1364,잔치,5,14,6,6,31
1380,사면,5,13,11,2,31
545,양보,19,5,5,2,31
1327,보류,5,18,7,1,31
2315,홀로,1,19,8,3,31
1284,근거,6,18,6,1,31
518,마린,20,1,7,2,30
1262,중도,6,21,2,1,30
1097,아시안,8,15,6,1,30
1646,고수,3,9,15,3,30
741,시절,13,6,7,4,30
770,조문,13,8,8,1,30
634,패럴림픽,17,3,8,2,30
1311,벌써,6,11,9,4,30
2208,코레일,1,21,7,1,30
1124,시점,7,18,3,2,30
1617,문턱,4,21,2,3,30
1130,은폐,7,6,14,3,30
595,해병대,17,1,11,1,30
744,불가능,13,11,3,3,30
1179,참여연대,7,12,8,3,30
1748,신화,3,16,6,5,30
1375,무효,5,6,17,2,30
1207,비행,6,19,3,2,30
493,순방,21,5,2,2,30
868,열차,11,5,9,5,30
713,세습,14,3,8,5,30
650,무관,16,7,5,2,30
1357,환경부,5,7,14,4,30
721,포착,14,6,9,1,30
779,반응,12,10,7,1,30
2325,주차장,1,14,14,1,30
1137,위헌,7,3,18,1,29
1607,독립,4,12,10,3,29
1738,취급,3,14,6,6,29
945,심야,10,8,10,1,29
1315,유포,6,4,18,1,29
2223,도서관,1,14,11,3,29
2166,김명수,1,2,24,2,29
1518,보조금,4,19,4,2,29
649,귀환,16,10,1,2,29
519,교황,20,1,3,5,29
1378,사유,5,11,12,1,29
856,접근,11,8,8,2,29
769,민족,13,5,7,4,29
2218,도박,1,2,19,7,29
1511,기도,4,7,15,3,29
2132,도우미,2,6,20,1,29
2455,건축,1,22,4,2,29
1335,고개,5,17,5,2,29
1013,자진,9,9,10,1,29
1498,압력,4,18,6,1,29
2272,추억,1,7,18,3,29
608,성명,17,6,5,1,29
1783,라면,3,14,11,1,29
1269,거짓,6,8,12,3,29
442,의제,24,2,2,1,29
2419,조각,1,1,3,23,28
832,농성,12,3,10,3,28
1138,셀프,7,10,10,1,28
621,주한,17,3,3,5,28
708,모임,14,5,6,3,28
1900,컴퓨터,2,19,5,2,28
1237,유예,6,18,2,2,28
1532,개정안,4,21,1,2,28
1025,논쟁,9,7,6,6,28
1759,경비원,3,2,22,1,28
2304,지배,1,22,3,2,28
1006,저녁,9,12,4,3,28
1301,무대,6,7,14,1,28
1100,대처,8,9,5,6,28
778,기업인,12,9,6,1,28
1489,발탁,4,17,5,2,28
918,전북,10,8,8,2,28
2449,남녀,1,10,14,3,28
581,병력,18,2,2,6,28
925,천안,10,3,14,1,28
1890,명령,2,19,5,2,28
1195,대안,7,15,4,2,28
2343,성적,1,13,13,1,28
1314,세기,6,4,8,10,28
2365,동네,1,13,10,3,27
989,해당,9,7,10,1,27
524,민생,20,3,3,1,27
1172,탑승,7,5,14,1,27
2139,일주일,1,17,8,1,27
2371,교섭,1,24,1,1,27
1005,위법,9,9,8,1,27
2361,만들기,1,17,5,4,27
1168,특정,7,10,9,1,27
1995,민원,2,11,13,1,27
1957,워크숍,2,16,8,1,27
582,집권,18,1,1,7,27
1500,신경,4,13,8,2,27
1975,전시,2,22,2,1,27
1779,덕분,3,14,7,3,27
2007,방해,2,6,15,4,27
767,수행,13,7,6,1,27
1081,화해,8,8,6,5,27
822,설득,12,11,3,1,27
469,만날,22,2,2,1,27
1063,심각,8,11,7,1,27
1107,정리,8,11,7,1,27
2038,상자,2,7,16,2,27
2043,학원,2,10,14,1,27
740,동해,13,4,9,1,27
891,일괄,11,13,1,2,27
735,호남,14,3,9,1,27
616,파행,17,2,6,2,27
2092,스타일,2,20,2,3,27
1121,시한,7,9,3,8,27
2467,초등생,1,2,22,1,26
1791,어르신,3,10,11,2,26
1208,고교,6,1,16,3,26
2468,게이트,1,17,7,1,26
2465,폐업,1,19,5,1,26
1230,외면,6,6,6,8,26
1971,프리,2,16,7,1,26
1614,세운,4,11,9,2,26
1466,고리,5,11,9,1,26
1307,분산,6,15,1,4,26
1756,부작용,3,17,3,3,26
652,즉각,16,4,3,3,26
1755,도시락,3,14,8,1,26
1354,교과서,5,5,6,10,26
1199,집사,7,5,13,1,26
2013,불똥,2,19,3,2,26
667,의회,15,5,5,1,26
943,서로,10,2,9,5,26
506,민심,21,2,2,1,26
698,인물,15,3,7,1,26
1359,존재,5,13,5,3,26
2102,등급,2,21,2,1,26
659,분위기,16,6,2,2,26
793,작성,12,6,7,1,26
1061,해석,8,12,2,4,26
590,날짜,18,4,2,2,26
2216,시즌,1,22,2,1,26
2258,각자,1,20,4,1,26
1254,사이버,6,13,4,3,26
1415,이슈,5,18,2,1,26
1445,모색,5,19,1,1,26
1413,흐름,5,16,1,4,26
2170,억대,1,8,15,2,26
534,국회의장,20,1,2,3,26
771,중재,13,8,3,1,25
1088,거절,8,4,9,4,25
1492,선호,4,19,1,1,25
2024,부터,2,7,8,8,25
1805,전교조,3,1,11,10,25
2162,비닐,1,9,13,2,25
665,민정,15,1,8,1,25
1348,보기,5,12,5,3,25
869,패싱,11,5,4,5,25
512,억류,21,1,2,1,25
1503,새만금,4,13,4,4,25
673,지도자,15,2,5,3,25
823,이면,12,6,5,2,25
2450,하우스,1,17,6,1,25
1882,가세,2,16,6,1,25
1333,번호,5,12,7,1,25
1176,당장,7,14,3,1,25
2321,어머니,1,2,18,4,25
1308,압축,6,10,8,1,25
1256,테러,6,6,9,4,25
1289,끼리,6,8,5,6,25
2394,임시,1,19,4,1,25
1132,여건,7,14,2,2,25
1461,연수,5,18,1,1,25
957,개념,10,12,2,1,25
1707,구입,3,16,5,1,25
1240,미흡,6,15,3,1,25
1232,정의,6,6,6,7,25
1660,고장,3,8,12,2,25
1548,온도,4,18,2,1,25
2224,직장,1,14,9,1,25
2444,속출,1,11,11,2,25
1392,휴일,5,7,12,1,25
2284,강사,1,11,11,2,25
842,무장,11,7,4,3,25
2072,동부,2,16,6,1,25
1204,메달,7,8,7,3,25
824,납치,12,1,11,1,25
517,리비아,20,1,1,3,25
1046,수립,8,14,2,1,25
1832,본인,3,13,7,2,25
1736,발급,3,16,2,3,24
942,이례,10,2,11,1,24
844,전격,11,9,2,2,24
1728,심장,3,16,3,2,24
1916,주인공,2,14,4,4,24
1351,뿌리,5,11,5,3,24
1193,파격,7,13,3,1,24
1716,지출,3,18,2,1,24
2034,유발,2,14,5,3,24
2443,컬링,1,10,12,1,24
1052,정치인,8,4,3,9,24
504,민병두,21,1,1,1,24
1409,행렬,5,8,9,2,24
1630,반납,4,11,8,1,24
1028,자신,9,6,8,1,24
2318,엘리베이터,1,16,6,1,24
1628,재고,4,13,3,4,24
1228,중인,6,9,8,1,24
2175,보급,1,17,4,2,24
1366,잡고,5,11,6,2,24
2466,수소차,1,20,1,2,24
1502,남아,4,12,7,1,24
1095,해도,8,8,5,3,24
2289,확충,1,20,1,2,24
696,소집,15,7,1,1,24
1834,불편,3,4,14,3,24
974,비서실,9,7,7,1,24
1746,번지,3,9,7,5,24
1598,무엇,4,9,3,8,24
1453,사표,5,7,9,2,23
1960,날개,2,16,2,3,23
1300,수단,6,13,3,1,23
826,중진,12,7,2,2,23
1471,갑자기,5,8,7,3,23
1478,김해,4,7,11,1,23
2316,매력,1,15,2,5,23
1437,신속,5,9,8,1,23
912,결심,10,2,10,1,23
1218,종결,6,5,11,1,23
1248,외출,6,5,10,2,23
1099,격려,8,9,5,1,23
1978,선생,2,2,16,3,23
1983,가게,2,8,10,3,23
2448,스트레스,1,11,10,1,23
1320,상실,6,6,10,1,23
1246,여기,6,7,5,5,23
1074,문서,8,8,6,1,23
1215,실천,6,14,2,1,23
613,무력,17,4,1,1,23
2357,흔적,1,3,17,2,23
1355,난항,5,14,3,1,23
2123,제일,2,14,3,4,23
1561,배려,4,11,3,5,23
870,다운,11,9,1,2,23
1353,합법,5,9,6,3,23
2194,경보,1,6,15,1,23
1551,소년,4,4,11,4,23
1263,해법,6,12,4,1,23
1040,약화,8,9,3,3,23
2190,월성,1,16,3,3,23
1919,도둑,2,14,5,2,23
836,사회주의,12,5,3,3,23
1559,감옥,4,1,13,5,23
1844,퇴근,3,13,6,1,23
2378,거품,1,17,1,4,23
2054,영양,2,10,9,2,23
1603,통한,4,16,1,2,23
958,대강,10,2,4,7,23
1747,멤버,3,4,14,1,22
2105,면접,2,15,4,1,22
1661,찾기,3,13,3,3,22
1781,링크,3,15,3,1,22
2003,장려,2,17,1,2,22
970,순직,9,2,10,1,22
1499,휴식,4,7,9,2,22
1580,식사,4,10,6,2,22
1151,정착,7,9,4,2,22
2261,전공,1,16,4,1,22
2472,국가대표,1,11,9,1,22
2330,학부모,1,2,18,1,22
1764,노동계,3,14,2,3,22
1763,장치,3,11,6,2,22
1448,진심,5,9,5,3,22
661,의전,16,3,1,2,22
1856,점거,2,6,13,1,22
1810,숙박,3,16,2,1,22
1062,헌법재판관,8,1,11,2,22
831,결단,12,4,3,3,22
1980,시계,2,11,8,1,22
2388,비만,1,15,4,2,22
2026,감자,2,18,1,1,22
2085,기승,2,10,9,1,22
2420,인류,1,17,2,2,22
1186,동북아,7,12,1,2,22
1677,얼마나,3,8,4,7,22
2309,사원,1,18,2,1,22
1476,상상,4,8,8,2,22
2478,업주,1,11,8,2,22
1390,수색,5,1,12,4,22
2436,우대,1,19,1,1,22
892,외신,11,2,7,2,22
1597,어선,4,1,15,2,22
1346,근본,5,13,1,3,22
1587,무게,4,11,4,2,21
2154,산불,1,3,16,1,21
784,실세,12,3,4,2,21
1631,고통,4,8,8,1,21
1468,로비,5,6,9,1,21
1622,올인,4,11,3,3,21
990,수여,9,4,7,1,21
2176,농촌,1,9,8,3,21
1875,우산,2,9,9,1,21
1782,간판,3,7,7,4,21
2471,둘째,1,2,16,2,21
1842,오히려,3,15,2,1,21
1288,진정,6,10,3,2,21
1544,규정,4,9,7,1,21
1669,황제,3,7,6,5,21
1371,내야,5,8,6,2,21
2350,피하,1,16,3,1,21
1708,시연,3,14,3,1,21
2477,소각,1,15,4,1,21
2348,작품,1,10,8,2,21
2063,불꽃,2,11,6,2,21
2197,무협,1,18,1,1,21
1927,오리,2,13,3,3,21
1345,외상,5,9,6,1,21
1822,지하,3,10,7,1,21
2089,젊은이,2,8,7,4,21
1674,수거,3,4,13,1,21
1671,관료,3,11,2,5,21
1238,마크,6,7,3,5,21
973,사죄,9,1,9,2,21
2495,동계올림픽,1,12,5,3,21
712,티스,14,4,1,2,21
1090,사안,8,4,7,2,21
1242,중대,6,11,3,1,21
1029,오사카,9,2,9,1,21
1644,고양이,3,5,7,6,21
1573,성적표,4,15,1,1,21
1493,휴대전화,4,9,6,2,21
1368,시청,5,8,7,1,21
916,현역,10,2,7,2,21
1911,전설,2,3,13,2,20
1838,태평양,3,11,4,2,20
1804,화제,3,10,6,1,20
2497,여수,1,13,4,2,20
1111,햄버거,8,7,4,1,20
2128,요리,2,11,6,1,20
1194,고향,7,2,9,2,20
1600,유가족,4,2,11,3,20
2422,영웅,1,3,14,2,20
1554,태양,4,14,1,1,20
1546,내내,4,3,11,2,20
1602,그냥,4,3,9,4,20
2157,가습기,1,15,3,1,20
1064,이메일,8,6,5,1,20
1653,탈취,3,13,3,1,20
944,지명,10,4,4,2,20
1164,어려움,7,9,3,1,20
2406,학습,1,14,3,2,20
1742,전부,3,6,9,2,20
1998,선풍기,2,15,1,2,20
1752,숫자,3,7,6,4,20
1649,압수,3,1,10,6,20
2294,화장,1,11,6,2,20
1964,고등,2,14,3,1,20
1290,유공,6,5,7,2,20
1387,추문,5,1,12,1,19
883,건국,11,1,5,2,19
1618,무릎,4,6,8,1,19
995,병사,9,3,5,2,19
1141,지침,7,9,2,1,19
1163,모습,7,3,8,1,19
1160,공백,7,8,2,2,19
1624,관행,4,11,3,1,19
1857,역설,2,10,3,4,19
1430,소설,5,6,6,2,19
2225,공공,1,12,4,2,19
1515,특례,4,8,5,2,19
1245,주일,6,6,5,2,19
2246,악몽,1,12,2,4,19
1477,유기,4,2,11,2,19
1621,불륜,4,1,13,1,19
798,시정,12,5,1,1,19
653,해리스,16,1,1,1,19
1183,배후,7,8,3,1,19
1970,건조,2,14,2,1,19
1939,카톡,2,13,3,1,19
2017,사인,2,9,7,1,19
2445,추월,1,14,2,2,19
745,쇄신,13,3,1,2,19
2052,어깨,2,5,10,2,19
1337,공론,5,8,2,4,19
1244,계절,6,10,1,2,19
1271,감당,6,7,2,4,19
1833,연령,3,11,3,2,19
2086,플랜,2,15,1,1,19
2097,과잉,2,13,3,1,19
1658,중독,3,5,9,2,19
2494,태블릿,1,9,8,1,19
2344,파산,1,10,6,1,18
1990,소문,2,10,5,1,18
2333,봉투,1,5,11,1,18
1908,한글,2,5,8,3,18
2014,김영란,2,8,7,1,18
821,김정일,12,1,3,2,18
2136,골목,2,8,6,2,18
2084,명문,2,5,6,5,18
2027,미얀마,2,14,1,1,18
1886,복직,2,3,11,2,18
2199,명중,1,10,6,1,18
800,해산,12,2,3,1,18
2424,실버,1,11,4,2,18
2360,상인,1,9,6,2,18
1870,선진국,2,13,2,1,18
2081,베일,2,13,2,1,18
2359,직업,1,7,7,3,18
1877,대여,2,14,1,1,18
1423,희생,5,2,9,2,18
904,통째,11,4,1,2,18
1091,이념,8,3,4,3,18
1382,발상,5,8,1,4,18
1049,과속,8,3,3,4,18
1841,노래방,3,5,9,1,18
1513,유일,4,7,4,3,18
1276,배경,6,8,3,1,18
1118,명칭,7,8,2,1,18
1277,자주,6,9,2,1,18
1051,존중,8,5,3,2,18
1343,기조,5,9,1,3,18
1719,지나,3,8,6,1,18
1534,국적,4,9,4,1,18
1287,가야,6,5,4,3,18
1625,난리,4,1,11,2,18
1813,정정,3,8,6,1,18
1038,하와이,8,5,4,1,18
980,당부,9,3,3,3,18
1139,제왕,7,1,4,6,18
1433,관여,5,3,9,1,18
1588,누진,4,11,1,2,18
1321,노벨상,6,5,2,5,18
1270,공동체,6,5,6,1,18
1191,사하라,7,3,7,1,18
919,응답,10,3,4,1,18
1222,도쿄,6,7,2,3,18
1754,비자,3,5,6,4,18
1201,사직,7,5,5,1,18
1407,장서,5,2,9,1,17
1987,달리,2,6,8,1,17
2336,오류,1,13,2,1,17
1316,한밤,6,2,8,1,17
1571,구분,4,11,1,1,17
775,정철,13,1,2,1,17
1761,대입,3,4,7,3,17
2214,고기,1,7,6,3,17
1286,영광,6,1,8,2,17
1279,최대한,6,8,1,2,17
1807,보이,3,6,3,5,17
937,애도,10,3,3,1,17
938,예의,10,5,1,1,17
2206,시속,1,8,7,1,17
1329,실체,5,4,6,2,17
2011,빈자리,2,13,1,1,17
1306,장병,6,3,7,1,17
1743,로켓,3,10,1,3,17
792,성의,12,2,2,1,17
988,비어,9,6,1,1,17
1000,강정,9,1,6,1,17
1553,청사,4,7,4,2,17
1136,근절,7,5,3,2,17
1792,조롱,3,1,11,2,17
1140,전방,7,4,2,4,17
1872,미약,2,3,11,1,17
1152,공직자,7,3,4,3,17
1767,구두,3,6,5,3,17
2177,국책,1,13,1,2,17
2286,급식,1,4,9,3,17
1683,편성,3,11,2,1,17
2096,탈락,2,8,5,2,17
2243,고령화,1,12,3,1,17
1845,스웨덴,3,9,1,4,17
1691,기한,3,10,3,1,17
1171,영구,7,3,6,1,17
1066,치유,8,2,6,1,17
1459,아무,5,1,5,6,17
1495,군인,4,4,8,1,17
1113,보라,8,5,2,2,17
1488,동력,4,10,2,1,17
1274,처럼,6,5,5,1,17
2265,식물,1,11,3,2,17
1101,주시,8,6,1,2,17
1221,문구,6,8,2,1,17
1676,무조건,3,5,6,3,17
2067,언론사,2,7,7,1,17
2486,오해,1,7,8,1,17
2317,앞바다,1,1,13,2,17
2282,조심,1,8,7,1,17
2508,유행,1,10,3,3,17
1341,군대,5,1,6,5,17
1520,동거,4,2,10,1,17
2280,추출,1,12,3,1,17
1394,입성,5,9,2,1,17
2091,화가,2,3,8,4,17
830,구상,12,2,1,2,17
1652,제소,3,12,1,1,17
2051,교실,2,9,3,3,17
2489,물건,1,8,7,1,17
2323,대륙,1,8,3,5,17
1666,지상파,3,8,5,1,17
962,대접,10,1,2,3,16
1693,차지,3,9,3,1,16
1757,세로,3,8,4,1,16
1685,연쇄,3,7,5,1,16
1604,문의,4,8,3,1,16
1750,목포,3,3,9,1,16
2059,전하,2,6,7,1,16
1672,증인,3,4,8,1,16
2093,안경,2,7,5,2,16
1422,배신,5,4,6,1,16
1344,외교관,5,1,9,1,16
932,출입,10,1,4,1,16
1147,고도,7,4,4,1,16
2104,축복,2,3,6,5,16
2029,가까이,2,11,2,1,16
1706,해커,3,11,1,1,16
1626,자해,4,2,8,2,16
1360,표시,5,7,3,1,16
1688,언론인,3,1,11,1,16
1938,일상,2,6,6,2,16
1843,박항서,3,3,8,2,16
1944,억제,2,11,2,1,16
1815,고백,3,2,8,3,16
2202,보전,1,9,5,1,16
2483,창작,1,11,1,3,16
1522,숙제,4,9,2,1,16
2484,대표팀,1,2,11,2,16
1952,뉴딜,2,12,1,1,16
1547,동아시아,4,5,3,4,16
2488,원천,1,12,2,1,16
1117,전투기,7,1,5,3,16
2324,화물차,1,8,6,1,16
1899,시안,2,6,6,2,16
866,연습,11,1,3,1,16
2268,표적,1,8,5,2,16
1266,부하,6,1,7,2,16
1778,격의,3,8,3,2,16
2275,배우자,1,7,6,1,15
1615,주역,4,3,6,2,15
941,질의,10,2,2,1,15
2179,입사,1,9,4,1,15
2135,베이,2,8,4,1,15
1447,여개,5,8,1,1,15
1529,할아버지,4,3,6,2,15
2407,괴담,1,3,7,4,15
2068,입시,2,4,3,6,15
2329,소녀,1,4,9,1,15
2274,물결,1,2,11,1,15
2426,금메달,1,5,6,3,15
1486,최후,4,5,5,1,15
1159,전술,7,2,4,2,15
2044,비극,2,3,6,4,15
2142,폴란드,1,9,4,1,15
1497,아야,4,8,1,2,15
1391,추구,5,7,2,1,15
1824,벼랑,3,7,2,3,15
1915,엄벌,2,3,6,4,15
1826,환상,3,1,4,7,15
1412,일자,5,6,2,2,15
1585,재앙,4,2,4,5,15
1148,위장전입,7,3,1,4,15
1190,실행,7,6,1,1,15
1192,거취,7,5,2,1,15
2181,그때,1,5,5,4,15
1774,그림자,3,8,1,3,15
908,외유,11,1,2,1,15
2185,전파,1,10,3,1,15
2453,터널,1,6,7,1,15
1205,복권,6,6,2,1,15
1963,부서,2,9,3,1,15
1562,강성,4,6,3,2,15
1549,기원,4,6,2,3,15
2439,네덜란드,1,6,5,3,15
2459,샤넬,1,9,3,2,15
2153,다툼,1,3,8,3,15
2151,타깃,1,11,2,1,15
1294,질타,6,4,4,1,15
936,공직,10,1,2,2,15
1441,우물,5,2,4,4,15
1145,봉합,7,5,2,1,15
1206,고집,6,3,1,5,15
2358,그녀,1,2,9,3,15
1188,운동권,7,1,4,3,15
2452,수감,1,2,11,1,15
1632,운전기사,4,3,6,1,14
1601,존경,4,5,3,2,14
1474,뭔가,4,3,1,6,14
993,함정,9,2,1,2,14
1542,분열,4,3,4,3,14
1473,아세안,4,8,1,1,14
1639,걸그룹,4,1,8,1,14
2174,외박,1,2,9,2,14
2074,모드,2,8,2,2,14
1467,더미,5,4,4,1,14
1110,압승,8,4,1,1,14
1543,여지,4,4,5,1,14
2173,한복,1,5,7,1,14
1675,공립,3,8,2,1,14
2267,차익,1,11,1,1,14
1643,스키,4,7,2,1,14
2332,노예,1,1,11,1,14
1595,직권,4,5,4,1,14
2165,예능,1,7,5,1,14
1636,쓰기,4,1,6,3,14
1668,고용노동부,3,7,3,1,14
1514,충분,4,5,4,1,14
1452,장면,5,5,3,1,14
1596,단순,4,8,1,1,14
2119,천국,2,3,8,1,14
2391,인지,1,10,2,1,14
2334,교육청,1,1,8,4,14
2158,라디오,1,6,4,3,14
1105,낙마,8,1,1,4,14
1788,만원,3,7,3,1,14
1816,소음,3,6,4,1,14
2009,사연,2,7,3,2,14
1934,놀이,2,5,5,2,14
1700,소유,3,6,3,2,14
1209,장군,6,3,4,1,14
1699,창구,3,9,1,1,14
2055,성향,2,6,4,2,14
1829,폭주,3,6,4,1,14
2427,품격,1,3,4,6,14
1695,되풀이,3,4,3,4,14
881,미국인,11,1,1,1,14
2062,부천,2,5,6,1,14
1717,전액,3,7,3,1,14
2041,집안,2,6,5,1,14
1803,무궁화,3,2,7,2,14
2460,활주로,1,3,9,1,14
1798,수십,3,4,6,1,14
1785,냄새,3,3,3,5,14
1954,우리나라,2,7,3,2,14
1352,세부,5,7,1,1,14
1896,억원,2,4,7,1,14
2327,맑은,1,3,8,1,13
2039,어른,2,3,4,4,13
1399,자존심,5,6,1,1,13
1924,학년,2,4,6,1,13
2230,포퓰리즘,1,3,1,8,13
1432,메모,5,1,6,1,13
1713,김밥,3,6,3,1,13
1123,행정부,7,4,1,1,13
1405,느낌,5,5,2,1,13
1181,김상곤,7,1,4,1,13
1718,칭찬,3,4,4,2,13
1054,임무,8,1,2,2,13
1296,보훈,6,3,3,1,13
2188,안위,1,8,3,1,13
1795,말로,3,7,1,2,13
1704,시비,3,1,8,1,13
1769,먹방,3,2,7,1,13
1909,수집,2,8,2,1,13
2302,부재,1,9,1,2,13
1481,법제처,4,5,3,1,13
2506,옥상,1,3,7,2,13
1862,퇴짜,2,4,1,6,13
1363,황당,5,4,3,1,13
1231,내기,6,2,4,1,13
1692,치명,3,7,2,1,13
2398,한판,1,7,4,1,13
2298,거대,1,9,2,1,13
1169,살포,7,1,4,1,13
1696,등산,3,3,5,2,13
1648,열정,3,4,5,1,13
1462,내정자,5,5,2,1,13
1667,역주행,3,5,2,3,13
1893,한국어,2,6,2,3,13
1589,예외,4,6,1,2,13
1702,공화국,3,3,1,6,13
1504,선포,4,7,1,1,13
2247,손상,1,7,4,1,13
1986,상식,2,4,6,1,13
1512,점점,4,3,4,2,13
2240,출산율,1,4,7,1,13
1454,과시,5,3,2,3,13
1007,테이블,9,1,1,1,12
1760,기상,3,4,4,1,12
2446,암초,1,8,2,1,12
1993,악성,2,7,1,2,12
1325,신년,6,2,3,1,12
1828,영향력,3,5,2,2,12
1035,싱크탱크,8,2,1,1,12
1796,절약,3,7,1,1,12
2337,위력,1,2,8,1,12
1055,잠수함,8,2,1,1,12
1078,도덕성,8,1,2,1,12
1599,애국,4,2,4,2,12
1458,번개,5,1,5,1,12
1507,고립,4,1,5,2,12
2310,선생님,1,3,5,3,12
1847,대중교통,3,2,6,1,12
2269,본질,1,3,3,5,12
2271,삼겹살,1,8,2,1,12
2502,미술,1,4,5,2,12
1994,정작,2,5,4,1,12
2075,제정,2,6,2,2,12
1397,천지,5,3,2,2,12
1606,심정,4,1,6,1,12
2021,안동,2,3,6,1,12
2147,코앞,1,8,2,1,12
2095,가기,2,4,5,1,12
1729,로남불,3,2,2,5,12
2047,허물,2,4,1,5,12
1611,질책,4,2,2,4,12
1705,자랑,3,5,1,3,12
1406,연출,5,1,5,1,12
2432,여유,1,7,3,1,12
2066,균형,2,7,1,2,12
2121,악용,2,6,1,3,12
1638,어버이날,4,4,3,1,12
2144,갈수록,1,6,4,1,12
2134,미소,2,5,4,1,12
2412,특급,1,3,7,1,12
1417,간첩,5,1,4,2,12
1642,복수,4,1,5,1,11
1745,역시,3,4,1,3,11
1085,정례,8,1,1,1,11
2228,이스라엘,1,6,1,3,11
1647,착각,3,2,5,1,11
2160,재생에너지,1,8,1,1,11
1219,현충원,6,2,1,2,11
2425,도덕,1,3,2,5,11
2226,길거리,1,3,6,1,11
1703,대량,3,5,2,1,11
1836,변명,3,3,3,2,11
1837,찬반,3,3,3,2,11
1250,표기,6,1,1,3,11
1236,용납,6,1,3,1,11
2403,초등,1,1,5,4,11
1258,퇴장,6,1,1,3,11
1180,화합,7,2,1,1,11
1681,괴물,3,1,5,2,11
2061,수험생,2,7,1,1,11
1884,학계,2,4,4,1,11
1273,남한,6,3,1,1,11
2300,호랑이,1,5,2,3,11
1342,환호,5,3,2,1,11
1664,도구,3,3,2,3,11
1275,우릴,6,1,2,2,11
2251,약자,1,6,3,1,11
1898,인척,2,2,4,3,11
1902,출력,2,7,1,1,11
1651,민주화,3,1,5,2,11
1935,노쇼,2,2,6,1,11
1567,수위,4,5,1,1,11
1318,대해,6,1,3,1,11
1799,우발,3,2,5,1,11
1765,접경,3,6,1,1,11
1420,명분,5,4,1,1,11
2168,개원,1,8,1,1,11
1768,일로,3,2,3,3,11
2433,공로,1,3,6,1,11
1741,만큼,3,4,3,1,11
1581,봉쇄,4,2,2,3,11
2184,자초,1,5,4,1,11
2186,성형,1,2,7,1,11
2341,다짐,1,7,2,1,11
1330,가라,5,3,1,2,11
1950,관찰,2,7,1,1,11
1996,가도,2,6,1,2,11
2152,공제,1,7,2,1,11
2279,해설,1,2,5,2,10
2002,천막,2,1,5,2,10
1662,전해,3,1,2,4,10
1861,보존,2,6,1,1,10
2252,정신질환,1,4,3,2,10
2035,손발,2,4,3,1,10
1386,욱일기,5,2,2,1,10
1711,신세,3,4,1,2,10
1680,몰락,3,4,1,2,10
2306,씨앗,1,6,2,1,10
1490,선글라스,4,4,1,1,10
1627,무능,4,1,1,4,10
1806,인격,3,2,4,1,10
1739,이건,3,1,4,2,10
1347,만드,5,2,1,2,10
1989,꼬리,2,2,4,2,10
2415,열쇠,1,1,6,2,10
1850,녹색,3,4,2,1,10
2345,교회,1,1,7,1,10
1885,우왕좌왕,2,5,2,1,10
1431,조사해,5,1,3,1,10
1734,망신,3,1,5,1,10
1659,감서,3,4,2,1,10
1801,무관심,3,4,2,1,10
2219,웃음,1,5,3,1,10
2431,그릇,1,2,6,1,10
1817,실력,3,4,1,2,10
1945,강국,2,6,1,1,10
2193,천재,1,4,3,2,10
2291,제청,1,4,4,1,10
1450,동지,5,1,3,1,10
1819,무허가,3,3,3,1,10
2116,거꾸로,2,2,1,5,10
2016,먹기,2,4,2,2,10
1831,감동,3,4,1,2,10
2245,차라리,1,5,1,3,10
1999,충성,2,3,1,4,10
1395,주석,5,2,1,2,10
2087,각오,2,3,2,3,10
1213,윤종원,6,2,1,1,10
1839,다보스,3,5,1,1,10
2437,주먹,1,2,6,1,10
1749,좌우,3,4,1,2,10
1726,관객,3,5,1,1,10
1777,불통,3,2,1,4,10
2287,한여름,1,5,1,2,9
2429,호킹,1,3,3,2,9
2307,판박이,1,2,5,1,9
2493,전이,1,6,1,1,9
1388,수호,5,2,1,1,9
2423,분리수거,1,1,6,1,9
2342,빌보드,1,2,5,1,9
2461,노리,1,1,6,1,9
2462,일본인,1,2,5,1,9
2463,직속,1,4,3,1,9
2339,이기,1,4,3,1,9
2328,제압,1,1,6,1,9
1282,첫걸음,6,1,1,1,9
2331,손주,1,1,6,1,9
1340,경의,5,1,1,2,9
2375,비관,1,6,1,1,9
1871,굴욕,2,2,3,2,9
2285,더욱,1,6,1,1,9
1773,출처,3,2,3,1,9
1808,지기,3,2,3,1,9
2221,형평성,1,5,2,1,9
2220,저주,1,4,2,2,9
1943,소신,2,3,3,1,9
1961,방망이,2,2,4,1,9
1962,오지,2,2,4,1,9
1968,역사상,2,3,3,1,9
2203,범죄자,1,2,5,1,9
2088,전락,2,4,2,1,9
1575,대적,4,3,1,1,9
2178,묘역,1,2,5,1,9
2010,김정,2,2,4,1,9
1516,자주포,4,2,2,1,9
1735,인사청문회,3,4,1,1,9
2148,훈련기,1,6,1,1,9
2143,절망,1,3,3,2,9
1609,부임,4,2,1,2,9
1710,적법,3,1,3,2,9
2049,업적,2,4,2,1,9
2109,이성,2,1,5,1,9
1657,깃발,3,4,1,1,9
2078,혐오,2,1,5,1,9
1665,물리,3,3,2,1,9
1679,자의,3,3,2,1,9
1932,여정,2,2,4,1,9
2189,채취,1,3,2,3,9
2283,개회,1,4,3,1,9
1860,권위,2,4,2,1,9
1858,행태,2,2,2,3,9
2278,개조,1,4,3,1,9
1869,쇄도,2,1,5,1,9
1863,저항,2,3,2,2,9
1906,정수,2,5,1,1,9
1483,불평등,4,2,1,2,9
1487,다해,4,2,1,2,9
1859,소원,2,1,5,1,9
1482,전례,4,3,1,1,9
2138,균열,2,3,2,1,8
2040,듯이,2,1,4,1,8
1715,역행,3,1,2,2,8
1629,회견,4,2,1,1,8
1464,타협,5,1,1,1,8
2498,사냥꾼,1,2,4,1,8
2155,정답,1,2,3,2,8
2050,쓰나미,2,2,3,1,8
2056,재능,2,2,2,2,8
2418,번진,1,3,2,2,8
2442,평등,1,1,4,2,8
1637,성주,4,1,2,1,8
2120,단절,2,4,1,1,8
2413,원자로,1,4,2,1,8
2411,연방,1,3,3,1,8
2077,폭격,2,2,3,1,8
1878,자꾸,2,1,4,1,8
2405,매뉴얼,1,1,5,1,8
2386,도마,1,5,1,1,8
1663,산물,3,3,1,1,8
2082,도청,2,3,2,1,8
2400,수백,1,2,3,2,8
1385,소나무,5,1,1,1,8
2355,엉터리,1,1,4,2,8
1820,서구,3,3,1,1,8
2008,슬픔,2,1,4,1,8
2183,특채,1,3,3,1,8
2470,기후,1,5,1,1,8
2312,유효,1,5,1,1,8
1530,경전,4,2,1,1,8
1979,움직,2,1,4,1,8
1956,문화유산,2,4,1,1,8
1959,지킴,2,3,2,1,8
1443,기득권,5,1,1,1,8
2257,추모식,1,2,4,1,8
1895,범법,2,2,3,1,8
1891,원래,2,2,3,1,8
2303,집필,1,1,3,3,8
2322,손바닥,1,3,3,1,8
1855,기만,2,3,1,2,8
2346,왕따,1,3,3,1,8
1772,참전,3,2,2,1,8
1812,과연,3,2,2,1,8
1917,출항,2,3,1,1,7
2080,다행,2,2,2,1,7
2473,인연,1,1,4,1,7
2474,그게,1,3,1,2,7
2487,눈빛,1,1,4,1,7
1811,방탄,3,2,1,1,7
1868,수로,2,2,2,1,7
2505,백년,1,3,1,2,7
1928,밥상,2,3,1,1,7
2479,음향,1,3,2,1,7
2410,로만,1,4,1,1,7
1997,조선시대,2,2,2,1,7
1942,합격자,2,3,1,1,7
1913,출하,2,3,1,1,7
1690,악순환,3,2,1,1,7
1912,양상,2,3,1,1,7
2417,기차,1,4,1,1,7
1846,중매,3,1,1,2,7
2028,나중,2,1,3,1,7
2025,선심,2,1,2,2,7
2023,이동식,2,3,1,1,7
1969,평일,2,3,1,1,7
1972,축사,2,2,2,1,7
1922,조의,2,1,3,1,7
1744,살림,3,2,1,1,7
2440,처지,1,3,2,1,7
1800,연가,3,1,1,2,7
1678,달인,3,2,1,1,7
2510,치기,1,2,3,1,7
2263,미팅,1,4,1,1,7
2234,병기,1,3,2,1,7
2235,현판,1,1,3,2,7
2215,키스,1,1,4,1,7
2238,겨눈,1,2,3,1,7
2126,노르웨이,2,2,2,1,7
2242,모자,1,2,2,2,7
2204,금도,1,3,1,2,7
1640,벨벳,4,1,1,1,7
1645,진영,3,1,1,2,7
2256,밀실,1,1,3,2,7
2308,족집게,1,4,1,1,7
2299,여러분,1,2,2,2,7
2352,민낯,1,3,1,2,7
1670,구경,3,1,2,1,7
2392,방패,1,1,4,1,7
2161,요소,1,4,1,1,7
2167,자서전,1,1,2,3,7
2381,가문,1,1,4,1,7
2363,번의,1,2,2,2,7
2273,무분별,1,1,1,4,7
1976,납득,2,2,1,1,6
1780,호프,3,1,1,1,6
2205,산실,1,3,1,1,6
2212,오바마,1,1,3,1,6
2172,메르켈,1,2,1,2,6
2171,중간광고,1,3,1,1,6
2469,찬물,1,2,2,1,6
2451,겨울철,1,2,2,1,6
2326,마나,1,2,1,2,6
1966,학점,2,1,1,2,6
2481,공연장,1,2,2,1,6
2231,장선,1,3,1,1,6
2232,절박,1,1,2,2,6
2236,죽지,1,2,2,1,6
2480,무너,1,3,1,1,6
1981,손짓,2,2,1,1,6
1925,출세,2,2,1,1,6
2241,감수,1,1,2,2,6
2313,잠시,1,3,1,1,6
2250,천명,1,1,2,2,6
2296,동남권,1,2,1,2,6
1883,부수,2,2,1,1,6
2504,바위,1,1,1,3,6
2276,출현,1,3,1,1,6
2290,홍수,1,1,2,2,6
2277,누굴,1,1,2,2,6
2349,빗속,1,2,2,1,6
2395,임자,1,1,3,1,6
1984,해프닝,2,1,2,1,6
2020,고비,2,1,1,2,6
2103,책상,2,2,1,1,6
1684,전념,3,1,1,1,6
2384,시트,1,3,1,1,6
2111,독수리,2,1,1,2,6
2070,건강검진,2,2,1,1,6
2374,장식,1,1,1,3,6
2053,석권,2,1,2,1,6
2370,상관,1,1,3,1,6
2421,저리,1,1,3,1,6
2369,항상,1,2,2,1,6
2351,파동,1,2,2,1,6
2367,맞선,1,2,2,1,6
2036,뭉치,2,1,2,1,6
2145,백종원,1,1,3,1,6
2180,개구리,1,2,2,1,6
2149,원점,1,3,1,1,6
2005,주머니,2,1,1,2,6
2441,국가보훈처,1,1,2,2,6
2353,예비군,1,1,3,1,6
1948,내분,2,1,1,1,5
2311,존폐,1,2,1,1,5
2376,몸짓,1,1,1,2,5
2254,몸통,1,1,2,1,5
2004,담당자,2,1,1,1,5
2259,독촉,1,1,2,1,5
2262,집착,1,2,1,1,5
1888,역적,2,1,1,1,5
1973,구체화,2,1,1,1,5
2071,결코,2,1,1,1,5
2397,남북한,1,1,2,1,5
2385,정하나,1,2,1,1,5
2293,머그컵,1,1,2,1,5
2292,려고,1,1,2,1,5
1865,달이,2,1,1,1,5
1867,성격,2,1,1,1,5
2389,나비,1,2,1,1,5
2390,꼼짝,1,2,1,1,5
2464,대답,1,1,1,2,5
2060,군함,2,1,1,1,5
2320,어민,1,1,2,1,5
2046,과오,2,1,1,1,5
2222,운동선수,1,1,2,1,5
2210,대지,1,2,1,1,5
2362,활개,1,1,1,2,5
2428,투성이,1,1,1,2,5
1933,제인,2,1,1,1,5
2140,새끼,1,1,2,1,5
2372,조언,1,2,1,1,5
1926,취할,2,1,1,1,5
2458,최소한,1,2,1,1,5
2482,말라리아,1,2,1,1,5
2319,코미디,1,1,1,1,4
2408,요트,1,1,1,1,4
2150,의사결정,1,1,1,1,4
2404,공해,1,1,1,1,4
2209,이제야,1,1,1,1,4
2305,식구,1,1,1,1,4
2456,억지로,1,1,1,1,4
2435,리다,1,1,1,1,4
2156,애완견,1,1,1,1,4
2217,진의,1,1,1,1,4
2146,미련,1,1,1,1,4
2485,설움,1,1,1,1,4
