,단어명,경제1분기빈도수,경제2분기빈도수,경제3분기빈도수,경제4분기빈도수,총빈도수
0,가상,113,15,9,3,140
1,화폐,110,17,12,4,143
2,톡톡,81,69,33,29,212
3,일상,79,68,32,27,206
4,삼성,72,114,86,33,305
5,인상,69,38,58,17,182
6,코노,68,69,67,31,235
7,브리핑,68,70,72,31,241
8,투자,64,33,69,42,208
9,최저임금,64,26,82,11,183
10,일자리,62,41,52,34,189
11,지원,62,49,78,22,211
12,김동연,59,52,56,26,193
13,시장,58,37,60,29,184
14,금융,57,70,68,48,243
15,해외,54,27,27,22,130
16,경영,51,21,42,8,122
17,롯데,50,25,30,20,125
18,금리,49,30,40,19,138
19,수출,48,37,43,15,143
20,관세,48,22,21,5,96
21,사업,47,35,50,18,150
22,최고,45,30,42,17,134
23,사회,44,13,28,9,94
24,플러스,43,37,8,4,92
25,산업,42,31,51,25,149
26,은행,42,23,40,20,125
27,매각,41,11,1,2,55
28,채용,41,40,20,9,110
29,국내,40,29,41,27,137
30,전자,40,34,34,18,126
31,작년,40,12,16,2,70
32,협상,40,5,5,2,52
33,대출,39,41,68,28,176
34,출시,39,50,39,31,159
35,청년,39,31,31,11,112
36,김현주,37,31,25,24,117
37,거래소,37,7,3,1,48
38,거래,37,15,25,8,85
39,노조,36,25,10,6,77
40,혁신,36,45,47,23,151
41,경제,35,45,70,37,187
42,업체,34,21,12,11,78
43,공장,34,16,15,6,71
44,논란,33,30,38,14,115
45,농협,33,42,43,23,141
46,확대,33,25,49,25,132
47,역대,33,16,24,6,79
48,증가,32,42,53,24,151
49,부담,31,12,23,13,79
50,규제,31,21,34,20,106
51,서비스,31,21,34,18,104
52,공헌,31,3,5,3,42
53,비트코인,30,5,2,1,38
54,개발,29,36,24,12,101
55,개최,28,40,26,17,111
56,직원,28,26,24,9,87
57,건설,28,15,21,10,74
58,대책,28,9,36,11,84
59,자금,27,7,14,9,57
60,기술,27,28,37,23,115
61,취업,26,15,25,14,80
62,세계,26,24,29,20,99
63,이주열,26,9,4,4,43
64,미국,25,12,16,6,59
65,강화,25,22,27,13,87
66,주택,25,23,47,18,113
67,위해,24,6,19,9,58
68,사장,24,14,12,5,55
69,한미,24,4,3,1,32
70,브랜드,24,15,15,12,66
71,비리,24,22,6,7,59
72,사상,24,9,15,8,56
73,성장,23,32,60,22,137
74,카드,23,13,31,12,79
75,안정,23,7,13,7,50
76,합의,22,18,5,3,48
77,관리,22,27,15,9,73
78,돌파,22,9,25,8,64
79,판매,22,24,18,14,78
80,폭탄,22,8,15,1,46
81,공정위,22,27,15,1,65
82,신규,21,9,19,6,55
83,금감원,21,32,16,4,73
84,생산,21,19,21,16,77
85,문제,21,13,14,11,59
86,진행,21,22,27,16,86
87,물가,21,13,30,13,77
88,소득,20,34,51,15,120
89,협력,20,20,26,4,70
90,그룹,20,47,28,5,100
91,전쟁,20,10,25,7,62
92,글로벌,20,14,22,17,73
93,무역,20,16,32,9,77
94,창업,20,20,10,13,63
95,강남,20,6,5,3,34
96,가격,20,21,21,14,76
97,부동산,20,10,33,17,80
98,중소기업,19,27,21,17,84
99,영업,19,14,30,8,71
100,대기업,18,18,25,9,70
101,결정,18,12,14,5,49
102,가맹,18,6,8,9,41
103,카카오,18,9,6,8,41
104,비상,18,3,13,1,35
105,피해,18,12,26,8,64
106,수요,18,4,14,2,38
107,정책,18,13,29,10,70
108,상승,18,15,38,17,88
109,중단,18,13,7,4,42
110,발표,17,7,22,14,60
111,시행,17,5,7,3,32
112,공인,17,4,26,6,53
113,오픈,17,9,20,7,53
114,블록,17,5,6,4,32
115,체인,17,6,6,4,33
116,인수,17,4,7,4,32
117,감소,17,8,31,26,82
118,아파트,17,4,19,14,54
119,신동빈,17,12,1,2,32
120,노사,16,17,6,7,46
121,현대,16,26,29,9,80
122,준비,16,8,6,8,38
123,최저,16,9,11,10,46
124,의혹,16,27,6,4,53
125,규모,16,14,9,5,44
126,이상,16,16,23,18,73
127,고객,16,9,8,11,44
128,가장,16,4,5,2,27
129,임금,16,9,11,5,41
130,트럼프,16,3,4,3,26
131,전환,16,8,13,8,45
132,계좌,16,1,3,2,22
133,커피,15,9,2,4,30
134,결제,15,7,3,4,29
135,가능성,15,12,6,4,37
136,공개,15,34,28,12,89
137,세금,15,5,13,2,35
138,실적,15,10,20,10,55
139,현대차,15,20,13,12,60
140,통화,15,4,1,2,22
141,확인,15,8,11,7,41
142,직장인,15,6,9,5,35
143,통해,15,5,9,1,30
144,중국,15,17,9,9,50
145,보험,15,14,21,7,57
146,하나,15,10,21,3,49
147,대우건설,15,5,3,1,24
148,국제,14,13,10,11,48
149,현장,14,17,16,8,55
150,신청,14,14,9,4,41
151,할인,14,14,15,11,54
152,플랫폼,14,2,7,3,26
153,고용,14,44,64,26,148
154,업계,14,23,26,17,80
155,가능,14,10,19,4,47
156,기준,14,13,10,3,40
157,하락,14,12,17,11,54
158,부과,14,2,2,1,19
159,유지,14,10,9,4,37
160,조사,14,17,16,16,63
161,투기,14,1,9,1,25
162,회사,14,7,7,5,33
163,전력,14,4,15,2,35
164,스타,13,8,10,3,34
165,김상조,13,19,10,4,46
166,압박,13,8,4,4,29
167,본부,13,2,8,3,26
168,계획,13,6,9,4,32
169,고발,13,7,12,3,35
170,광고,13,8,13,7,41
171,예상,13,5,5,4,27
172,활성화,13,7,5,3,28
173,우려,13,15,22,13,63
174,통상,13,1,2,5,21
175,도입,13,13,17,11,54
176,속도,13,13,18,6,50
177,회복,13,11,15,7,46
178,인사,13,8,3,3,27
179,추가,13,13,25,9,60
180,소상,13,3,25,4,45
181,가계,13,18,18,8,57
182,외식,13,4,1,1,19
183,상생,12,5,24,5,46
184,시대,12,16,12,12,52
185,본격,12,9,7,4,32
186,소비,12,11,23,6,52
187,이벤트,12,13,8,11,44
188,자율,12,7,1,8,28
189,이후,12,8,14,6,40
190,검토,12,15,29,12,68
191,진출,12,12,15,8,47
192,집값,12,6,40,7,65
193,자동차,12,14,13,9,48
194,수입,12,13,16,7,48
195,안전,12,13,14,9,48
196,대응,12,15,9,3,39
197,지역,12,21,25,8,66
198,주식,12,19,8,7,46
199,희망,12,8,35,5,60
200,선정,12,13,13,2,40
201,사드,12,9,1,2,24
202,대상,12,11,19,8,50
203,소비자,12,5,25,9,51
204,실업률,12,2,6,3,23
205,여성,12,11,10,9,42
206,실시,12,19,15,9,55
207,확산,12,10,15,4,41
208,쇼핑,12,6,13,4,35
209,한파,12,1,1,3,17
210,센터,11,9,9,3,32
211,점검,11,11,16,1,39
212,매출,11,14,13,13,51
213,최초,11,10,9,4,34
214,연속,11,12,19,9,51
215,자산,11,11,9,4,35
216,뱅크,11,6,5,2,24
217,평가,11,9,4,3,27
218,참여,11,10,14,6,41
219,과세,11,2,12,1,26
220,프랜차이즈,11,5,5,2,23
221,면제,11,5,7,3,26
222,조선,11,15,1,1,28
223,이재용,11,16,12,3,42
224,공공기관,11,6,6,5,28
225,개인,11,9,2,4,26
226,스마트폰,11,12,7,6,36
227,위기,11,18,17,7,53
228,보복,11,5,1,1,18
229,제품,11,9,13,4,37
230,국가,11,9,5,2,27
231,국세청,11,5,9,1,26
232,재정,11,3,12,1,27
233,해결,11,5,4,2,22
234,행사,11,11,10,11,43
235,우리,11,11,19,4,45
236,충격,11,3,5,3,22
237,선물,11,2,4,1,18
238,회의,11,7,9,6,33
239,비용,11,4,7,9,31
240,사용,11,5,11,1,28
241,지난해,11,6,6,5,28
242,공무원,10,9,3,8,30
243,채권,10,3,6,5,24
244,감사,10,4,5,13,32
245,육박,10,6,15,9,40
246,환율,10,14,5,4,33
247,세트,10,2,3,1,16
248,계약,10,10,9,4,33
249,경기,10,15,33,21,79
250,폐지,10,9,14,5,38
251,마트,10,7,3,2,22
252,사실,10,8,7,1,26
253,노인,10,4,2,2,18
254,보청기,10,2,9,2,23
255,아이,10,6,8,2,26
256,비중,10,8,9,2,29
257,전국,10,13,13,14,50
258,여행,10,6,6,4,26
259,참가,10,3,5,4,22
260,프리미엄,10,7,12,3,32
261,적발,10,8,9,4,31
262,결과,10,4,7,5,26
263,요청,10,5,4,1,20
264,상품,10,10,12,3,35
265,체결,10,10,12,7,39
266,달러,10,9,3,2,24
267,네이버,10,9,2,3,24
268,온라인,10,7,12,5,34
269,평균,10,18,24,9,61
270,치킨,10,11,2,5,28
271,사랑,10,6,10,2,28
272,개편,9,11,18,2,40
273,기념,9,8,12,6,35
274,인하,9,6,12,17,44
275,베트남,9,6,4,5,24
276,발전,9,8,17,3,37
277,책임,9,8,11,6,34
278,절반,9,7,9,7,32
279,국민연금,9,18,37,10,74
280,반도체,9,10,16,8,43
281,수익,9,1,2,5,17
282,개선,9,18,16,11,54
283,전략,9,8,7,1,25
284,가동,9,10,7,3,29
285,기관,9,8,6,4,27
286,적자,9,5,4,3,21
287,수수료,9,5,12,7,33
288,연봉,9,8,3,2,22
289,급등,9,6,10,5,30
290,생활,9,11,8,3,31
291,제공,9,10,8,3,30
292,반대,9,5,4,3,21
293,주행,9,4,3,5,21
294,필요,9,19,14,12,54
295,개시,9,1,1,1,12
296,게임,9,9,9,4,31
297,장관,9,8,16,3,36
298,전달,9,4,7,1,21
299,캠페인,9,7,5,2,23
300,악재,9,2,5,2,18
301,수급,9,2,9,3,23
302,증시,9,6,3,14,32
303,시세,9,2,2,1,14
304,부회장,8,9,11,1,29
305,정상화,8,9,3,3,23
306,증권,8,34,12,2,56
307,우정,8,1,3,1,13
308,건강,8,17,8,4,37
309,협의,8,4,10,6,28
310,이자,8,6,4,3,21
311,대형,8,3,7,2,20
312,테크,8,6,3,5,22
313,포스코,8,19,11,3,41
314,일부,8,7,11,1,27
315,이용,8,7,8,2,25
316,효과,8,14,26,8,56
317,이익,8,9,13,3,33
318,사고,8,13,12,5,38
319,현실,8,8,8,1,25
320,급증,8,10,13,7,38
321,성공,8,6,10,2,26
322,국산,8,9,1,4,22
323,분쟁,8,5,11,4,28
324,구조조정,8,1,7,1,17
325,유통,8,8,9,3,28
326,국민,8,7,17,10,42
327,가구,8,12,21,6,47
328,통합,8,3,6,1,18
329,혜택,8,6,17,5,36
330,영향,8,12,10,8,38
331,단체,8,5,9,5,27
332,개혁,8,9,11,5,33
333,기재부,8,2,4,4,18
334,수주,8,5,12,2,27
335,스마트,8,11,17,8,44
336,사업자,8,8,7,2,25
337,철도,8,9,1,1,19
338,육성,8,6,5,1,20
339,논의,8,12,16,4,40
340,기록,8,8,3,6,25
341,보유,8,5,5,7,25
342,주주,8,5,3,1,17
343,최악,8,7,8,4,27
344,지속,8,5,9,3,25
345,부실,8,3,4,1,16
346,포기,8,1,2,1,12
347,방문,8,7,11,2,28
348,대비,8,15,16,7,46
349,연금,7,6,28,5,46
350,출범,7,6,10,6,29
351,등장,7,3,3,1,14
352,제도,7,7,4,1,19
353,구매,7,2,4,6,19
354,임원,7,9,4,3,23
355,모델,7,11,2,1,21
356,전문,7,5,12,7,31
357,특별,7,8,15,2,32
358,당국,7,8,3,9,27
359,디지털,7,7,7,11,32
360,맞춤,7,4,4,1,16
361,고속도로,7,3,5,3,18
362,교육,7,7,12,4,30
363,행복,7,2,9,2,20
364,시스템,7,17,9,7,40
365,검사,7,6,4,3,20
366,바이오,7,15,17,15,54
367,동반,7,4,2,3,16
368,중앙회,7,9,7,5,28
369,방안,7,8,11,2,28
370,확장,7,2,5,2,16
371,편의점,7,7,15,6,35
372,요구,7,12,8,1,28
373,농업,7,9,6,1,23
374,목표,7,5,5,8,25
375,적용,7,7,12,8,34
376,서민,7,2,10,6,25
377,선택,7,8,6,3,24
378,상반기,7,4,36,1,48
379,코레일,7,6,5,2,20
380,가치,7,10,9,8,34
381,전문가,7,6,8,4,25
382,구속,7,4,3,3,17
383,갤럭시,7,1,4,2,14
384,검찰,7,14,8,1,30
385,예금,7,4,4,4,19
386,프로모션,7,5,3,4,19
387,공동,7,4,8,8,27
388,종합,7,8,17,5,37
389,최종,7,10,11,7,35
390,신고,7,7,7,1,22
391,사태,7,17,7,1,32
392,조정,7,2,7,9,25
393,코리아,7,10,8,9,34
394,전망,7,10,21,18,56
395,활용,7,7,12,5,31
396,신설,7,10,5,1,23
397,뉴스,7,9,4,4,24
398,로또,7,8,6,2,23
399,수사,7,14,5,1,27
400,이슈,7,12,8,9,36
401,첫날,7,1,2,3,13
402,수준,7,6,12,6,31
403,구축,7,6,13,4,30
404,보호무역,7,3,1,1,12
405,가속,7,5,6,1,19
406,전세,6,7,8,2,23
407,위반,6,8,5,2,21
408,노력,6,1,3,3,13
409,사람,6,5,4,3,18
410,긴급,6,1,6,2,15
411,유치,6,8,2,3,19
412,변화,6,10,6,5,27
413,재벌,6,14,3,1,24
414,승계,6,2,3,2,13
415,그린,6,4,5,1,16
416,작업,6,4,3,2,15
417,백화점,6,4,4,3,17
418,체감,6,3,11,7,27
419,신제품,6,6,6,5,23
420,호텔,6,5,8,1,20
421,공사,6,12,13,4,35
422,비정규직,6,6,2,3,17
423,인기,6,9,10,6,31
424,직장,6,6,5,3,20
425,문화,6,10,16,7,39
426,활동,6,4,15,2,27
427,투입,6,9,10,5,30
428,미세먼지,6,9,3,5,23
429,중견,6,1,1,1,9
430,완화,6,9,22,2,39
431,예산,6,7,24,1,38
432,직격탄,6,2,1,3,12
433,배제,6,2,2,6,16
434,공식,6,4,7,4,21
435,보고,6,4,2,1,13
436,보장,6,4,5,1,16
437,손실,6,2,4,3,15
438,확정,6,11,3,1,21
439,폭락,6,1,4,7,18
440,기준금리,6,4,6,3,19
441,목소리,6,3,3,4,16
442,사과,6,3,6,2,17
443,모든,6,3,5,2,16
444,내달,6,3,5,1,15
445,판단,6,7,6,1,20
446,확보,6,6,11,5,28
447,도로,6,2,3,2,13
448,손경,6,2,2,1,11
449,위험,6,9,7,2,24
450,항공,6,9,12,8,35
451,단축,6,8,3,3,20
452,시험,6,4,5,2,17
453,대박,6,4,2,1,13
454,대규모,6,5,6,3,20
455,아시아나,6,2,19,1,28
456,설명,6,5,7,3,21
457,도약,6,5,2,1,14
458,피해자,6,4,4,3,17
459,정규직,6,5,3,5,19
460,제재,6,5,7,2,20
461,보호,6,8,5,3,22
462,제한,6,14,16,1,37
463,붕괴,6,1,7,2,16
464,교체,6,6,2,5,19
465,기간,6,2,4,5,17
466,관심,6,3,1,2,12
467,금지,6,6,8,4,24
468,쇼핑몰,6,1,7,2,16
469,연구,6,4,7,4,21
470,허용,6,3,6,4,19
471,맥주,6,3,3,2,14
472,기능,6,5,7,4,22
473,출발,5,3,3,3,14
474,초과,5,2,3,2,12
475,한우,5,10,4,4,23
476,환경,5,8,10,5,28
477,전면,5,3,7,2,17
478,공유,5,5,7,7,24
479,임대,5,1,10,9,25
480,일감,5,6,6,1,18
481,주년,5,3,5,6,19
482,탈출,5,1,3,1,10
483,협약,5,10,13,6,34
484,입장,5,1,3,1,10
485,불가피,5,6,1,1,13
486,제조업,5,9,8,6,28
487,설립,5,3,6,4,18
488,신세계,5,8,6,1,20
489,페이스북,5,2,1,1,9
490,정보,5,7,9,4,25
491,시동,5,5,6,1,17
492,관련,5,9,5,4,23
493,절차,5,3,3,1,12
494,유출,5,8,4,2,19
495,박람회,5,2,5,3,15
496,프로그램,5,5,1,3,14
497,에너지,5,8,7,2,22
498,복지,5,2,8,6,21
499,공간,5,7,4,4,20
500,민간,5,7,3,4,19
501,적극,5,7,5,3,20
502,한도,5,1,5,2,13
503,현상,5,2,1,1,9
504,일본,5,6,7,1,19
505,중소,5,2,4,1,12
506,선언,5,4,2,2,13
507,기회,5,5,1,2,13
508,재계,5,9,9,1,24
509,부진,5,7,9,10,31
510,제안,5,2,5,1,13
511,유럽,5,6,8,3,22
512,통신,5,5,2,1,13
513,지정,5,13,8,2,28
514,돌입,5,2,4,3,14
515,회수,5,2,3,2,12
516,분야,5,3,7,1,16
517,코스피,5,3,4,7,19
518,공포,5,2,1,3,11
519,유예,5,5,2,1,13
520,조치,5,7,4,4,20
521,홈쇼핑,5,8,5,3,21
522,운영,5,13,9,3,30
523,한국은행,5,1,1,1,8
524,계속,5,7,9,3,24
525,농산물,5,5,2,2,14
526,국토부,5,11,13,5,34
527,보안,5,2,5,4,16
528,반발,5,7,13,4,29
529,부정,5,4,2,4,15
530,가입,5,9,9,1,24
531,최소,5,10,12,1,28
532,택시,5,3,2,6,16
533,선도,5,6,3,2,16
534,처분,5,9,3,1,18
535,월급,5,7,3,3,18
536,지방,5,1,4,2,12
537,로봇,5,4,4,4,17
538,폭풍,5,4,8,1,18
539,산업혁명,5,6,6,7,24
540,금제,5,4,2,2,13
541,도시,5,6,4,5,20
542,라면,5,1,1,5,12
543,껑충,5,8,7,6,26
544,런칭,5,6,3,3,17
545,모집,5,9,5,3,22
546,흑자,5,6,8,2,21
547,공유경제,5,2,2,3,12
548,공단,5,15,4,2,26
549,연장,5,3,6,1,15
550,화장품,5,5,3,2,15
551,열풍,5,3,1,1,10
552,발견,5,5,6,3,19
553,업무,5,7,10,8,30
554,금융위,5,2,4,3,14
555,외국인,5,11,6,6,28
556,면세점,5,6,11,1,23
557,변수,5,1,3,1,10
558,핵심,5,6,13,4,28
559,규정,5,3,3,1,12
560,눈길,5,2,6,5,18
561,구조,5,3,3,4,15
562,담보,5,5,4,5,19
563,계층,5,2,7,3,17
564,공감,5,4,2,1,12
565,기부,5,3,8,1,17
566,동결,5,4,8,2,19
567,합병,5,10,4,2,21
568,장기,5,5,10,7,27
569,불안,5,5,12,3,25
570,연체,5,2,7,4,18
571,자료,5,3,2,1,11
572,바람,5,2,5,4,16
573,부처,5,3,2,4,14
574,가전,5,4,6,3,18
575,긍정,5,2,2,3,12
576,집중,5,6,19,5,35
577,이틀,5,3,3,1,12
578,아이폰,5,1,2,4,12
579,처음,5,2,2,1,10
580,교수,5,3,3,2,13
581,스타벅스,4,2,3,2,11
582,조금,4,5,2,1,12
583,수용,4,6,3,1,14
584,자본,4,4,1,1,10
585,공정,4,5,9,2,20
586,위원장,4,6,5,1,16
587,반영,4,3,4,5,16
588,성과,4,6,7,5,22
589,창립,4,4,1,3,12
590,결렬,4,4,1,1,10
591,불가,4,3,3,2,12
592,하츠,4,3,3,2,12
593,세대,4,7,9,3,23
594,인건비,4,1,3,2,10
595,취약,4,3,9,2,18
596,의무,4,2,6,5,17
597,분양,4,1,4,13,22
598,알바,4,3,5,1,13
599,라인,4,5,4,3,16
600,수협,4,7,3,5,19
601,가계부채,4,2,5,3,14
602,부문,4,6,4,3,17
603,라이트,4,1,6,1,12
604,소통,4,2,3,1,10
605,인구,4,4,2,4,14
606,해소,4,10,10,3,27
607,프로젝트,4,2,9,2,17
608,과정,4,3,1,5,13
609,스포츠,4,7,2,2,15
610,공공,4,1,3,1,9
611,컨설팅,4,4,1,2,11
612,어디,4,4,9,2,19
613,실내,4,4,1,1,10
614,공략,4,2,8,1,15
615,고민,4,1,3,2,10
616,국회,4,3,9,2,18
617,갈등,4,8,7,4,23
618,트럭,4,2,1,1,8
619,매장,4,3,4,4,15
620,빅데이터,4,4,6,1,15
621,정상,4,3,2,1,10
622,심화,4,5,8,2,19
623,퇴직,4,8,4,2,18
624,디자인,4,6,5,2,17
625,예고,4,4,10,4,22
626,주말,4,1,5,1,11
627,착수,4,10,7,3,24
628,레드,4,2,4,1,11
629,대림,4,3,1,1,9
630,한번,4,1,3,1,9
631,하도급,4,4,2,1,11
632,정지,4,2,6,1,13
633,축소,4,1,9,1,15
634,주목,4,13,12,5,34
635,주의,4,2,10,1,17
636,복합,4,4,5,3,16
637,협회,4,7,12,5,28
638,진단,4,2,12,1,19
639,배달,4,3,2,4,13
640,의지,4,1,1,1,7
641,둔화,4,4,2,2,12
642,스토어,4,5,2,1,12
643,푸드,4,2,4,3,13
644,대한민국,4,3,3,2,12
645,패키지,4,2,2,3,11
646,중심,4,6,7,3,20
647,체험,4,10,3,4,21
648,패션,4,5,3,2,14
649,총력,4,5,8,1,18
650,여부,4,7,4,1,16
651,병원,4,6,9,1,20
652,박용만,4,1,3,2,10
653,수상,4,3,2,1,10
654,기반,4,6,3,2,15
655,드론,4,23,2,25,54
656,기초,4,3,6,1,14
657,도움,4,3,1,2,10
658,휴가,4,4,11,2,21
659,화학,4,2,7,1,14
660,외환,4,2,2,2,10
661,여파,4,7,4,4,19
662,겨냥,4,1,2,1,8
663,지주사,4,4,2,3,13
664,원가,4,5,1,4,14
665,인천,4,4,9,6,23
666,침체,4,3,5,2,14
667,우수,4,5,4,5,18
668,고가,4,3,4,1,12
669,실업,4,2,5,1,12
670,여전,4,2,4,4,14
671,생각,4,2,1,6,13
672,체제,4,2,7,2,15
673,원전,4,10,25,5,44
674,미디어,4,1,2,1,8
675,걱정,4,4,7,1,16
676,부작용,4,4,2,1,11
677,인정,4,7,3,1,15
678,예약,4,4,5,1,14
679,전자담배,4,2,1,1,8
680,스타트업,4,3,5,6,18
681,전남,4,1,1,2,8
682,불법,4,11,6,5,26
683,인도,4,3,5,1,13
684,개장,4,2,2,2,10
685,신용,4,9,4,4,21
686,전통,4,4,4,1,13
687,캠프,4,2,3,1,10
688,친환경,4,5,9,5,23
689,반려동물,4,1,1,1,7
690,펀드,4,9,5,5,23
691,우리은행,4,10,3,4,21
692,암호,4,2,5,1,12
693,세탁기,4,3,1,1,9
694,차세대,4,3,1,1,9
695,연말,4,1,3,3,11
696,캐릭터,3,2,3,2,10
697,간담,3,1,3,1,8
698,점포,3,1,3,1,8
699,바다,3,2,1,1,7
700,촉구,3,2,4,1,10
701,어린이,3,1,7,4,15
702,대회,3,4,3,5,15
703,박차,3,3,2,7,15
704,급락,3,3,3,4,13
705,강행,3,1,1,1,6
706,연간,3,1,1,2,7
707,경쟁,3,8,8,5,24
708,보고서,3,8,4,1,16
709,관광,3,5,7,5,20
710,도시재생,3,3,6,2,14
711,단계,3,2,2,1,8
712,보험료,3,3,6,2,14
713,조성,3,3,8,2,16
714,관건,3,4,7,1,15
715,경상수지,3,1,2,1,7
716,쿼터,3,1,4,1,9
717,환영,3,1,2,1,7
718,사망,3,2,3,3,11
719,만족도,3,2,1,2,8
720,재산,3,4,1,3,11
721,분석,3,3,3,3,12
722,철회,3,7,2,2,14
723,파업,3,2,7,2,14
724,대한항공,3,28,10,2,43
725,폐업,3,3,2,5,13
726,장사,3,4,3,1,11
727,쇼크,3,9,17,3,32
728,능력,3,2,3,2,10
729,데이,3,2,1,5,11
730,대폭,3,2,8,6,19
731,수도,3,4,7,1,15
732,마무리,3,4,3,2,12
733,프로,3,5,2,3,13
734,성분,3,1,1,2,7
735,상황,3,4,8,4,19
736,얼마나,3,2,4,1,10
737,속보,3,1,10,1,15
738,나라,3,1,3,1,8
739,시설,3,7,8,3,21
740,개인정보,3,3,1,1,8
741,개국,3,5,7,4,19
742,촉각,3,2,2,1,8
743,단신,3,6,5,1,15
744,개사,3,1,2,1,7
745,투명,3,3,1,2,9
746,물산,3,4,1,1,9
747,모바일,3,9,9,5,26
748,점주,3,3,3,6,15
749,제작,3,3,6,2,14
750,사기,3,4,3,1,11
751,홍보,3,5,4,7,19
752,양성,3,1,3,1,8
753,발목,3,3,2,3,11
754,월간,3,3,2,4,12
755,팝업,3,3,1,1,8
756,인간,3,2,1,2,8
757,세상,3,1,1,1,6
758,이통,3,14,7,4,28
759,간편,3,2,3,2,10
760,이름,3,1,2,1,7
761,매진,3,1,3,1,8
762,당첨,3,7,4,6,20
763,불공정,3,4,4,1,12
764,고공,3,2,5,1,11
765,기질,3,2,1,2,8
766,일로,3,1,2,1,7
767,임대주택,3,2,4,1,10
768,석탄,3,2,7,7,19
769,시티,3,10,4,3,20
770,고려,3,3,8,2,16
771,매매,3,3,3,2,11
772,생태계,3,2,3,3,11
773,제휴,3,5,2,1,11
774,직무,3,1,5,1,10
775,창의,3,1,1,4,9
776,먹거리,3,1,4,1,9
777,부품,3,2,6,4,15
778,선수,3,2,2,1,8
779,행진,3,5,11,3,22
780,나이,3,1,1,2,7
781,처리,3,5,8,5,21
782,인프라,3,1,1,4,9
783,뉴욕,3,3,1,2,9
784,식품,3,11,6,2,22
785,이사장,3,2,2,1,8
786,재단,3,4,5,3,15
787,심리,3,1,10,1,15
788,순환,3,3,3,1,10
789,원장,3,2,3,3,11
790,감자,3,3,1,3,10
791,불황,3,5,2,3,13
792,항공사,3,3,5,4,15
793,페이,3,5,1,2,11
794,인공,3,5,2,2,12
795,린다,3,5,2,3,13
796,본사,3,13,5,4,25
797,생명,3,6,13,1,23
798,스위스,3,1,1,1,6
799,특혜,3,4,1,2,10
800,할증,3,1,1,1,6
801,부모,3,1,6,1,11
802,악화,3,3,9,5,20
803,금수,3,2,2,2,9
804,민관,3,2,2,1,8
805,국세,3,2,3,2,10
806,도전,3,3,6,1,13
807,노비타,3,4,2,1,10
808,조기,3,2,5,4,14
809,배터리,3,4,4,2,13
810,의심,3,2,7,6,18
811,벌써,3,2,1,1,7
812,탄생,3,1,1,1,6
813,목적,3,2,1,2,8
814,애플,3,6,5,2,16
815,동남아,3,1,6,2,12
816,마케팅,3,8,5,3,19
817,사례,3,1,3,2,9
818,차량,3,6,9,7,25
819,꼼수,3,3,3,1,10
820,역할,3,5,2,2,12
821,반등,3,2,3,6,14
822,한진,3,25,2,1,31
823,외부,3,4,2,5,14
824,시급,3,2,6,1,12
825,시중,3,1,3,3,10
826,사용자,3,5,7,1,16
827,달성,3,5,3,4,15
828,상환,2,2,2,2,8
829,시상식,2,2,1,2,7
830,수산,2,2,1,1,6
831,청정,2,1,2,1,6
832,제주항공,2,1,2,2,7
833,진화,2,7,7,2,18
834,지수,2,1,8,6,17
835,대체,2,4,2,4,12
836,연구소,2,3,1,1,7
837,미만,2,1,4,2,9
838,특허,2,3,1,1,7
839,선점,2,1,1,2,6
840,도어,2,1,1,1,5
841,비판,2,6,3,1,12
842,운용,2,1,3,4,10
843,물류,2,1,2,2,7
844,장애인,2,1,3,2,8
845,조직,2,4,4,1,11
846,청소년,2,4,3,1,10
847,거점,2,2,1,1,6
848,농가,2,4,4,1,11
849,발생,2,6,6,1,15
850,비즈니스,2,1,3,1,7
851,상담,2,4,8,1,15
852,사항,2,2,2,2,8
853,행차,2,2,1,1,6
854,편성,2,3,3,1,9
855,국면,2,2,5,2,11
856,부채,2,1,3,3,9
857,찬성,2,3,4,2,11
858,개관,2,1,1,1,5
859,대신,2,5,1,2,10
860,이하,2,4,4,4,14
861,대우,2,2,2,1,7
862,요금,2,12,14,3,31
863,지하철,2,2,1,1,6
864,월드,2,3,4,3,12
865,구성,2,2,4,1,9
866,셀프,2,1,2,1,6
867,물량,2,2,1,2,7
868,발굴,2,3,7,3,15
869,배송,2,1,2,2,7
870,면담,2,5,2,1,10
871,해운,2,1,2,1,6
872,변동,2,6,2,1,11
873,차이,2,6,2,1,11
874,국민은행,2,3,4,1,10
875,이노,2,1,5,1,9
876,시범,2,4,4,2,12
877,동영상,2,4,3,2,11
878,방향,2,4,1,1,8
879,부활,2,4,2,2,10
880,본부장,2,1,1,1,5
881,눈앞,2,1,1,3,7
882,실효,2,3,6,1,12
883,의사,2,1,5,4,12
884,산업부,2,3,10,1,16
885,글쎄,2,3,1,2,8
886,가스,2,3,6,2,13
887,업종,2,5,7,1,15
888,중요,2,2,3,1,8
889,고위,2,1,1,2,6
890,마이,2,4,5,2,13
891,향후,2,1,1,3,7
892,실종,2,1,1,1,5
893,물살,2,2,1,1,6
894,케이,2,1,3,1,7
895,영상,2,3,4,2,11
896,김현미,2,2,7,4,15
897,트렌드,2,3,3,1,9
898,가족,2,5,3,4,14
899,기획,2,2,4,5,13
900,미니,2,3,4,1,10
901,주기,2,1,1,1,5
902,벤처기업,2,4,2,3,11
903,누가,2,6,4,1,13
904,기계,2,1,3,1,7
905,무상,2,2,4,1,9
906,열사,2,4,6,3,15
907,솔루션,2,2,7,4,15
908,개막,2,2,6,2,12
909,일제,2,3,1,3,9
910,나선,2,2,11,3,18
911,발행,2,1,3,5,11
912,축산,2,11,1,1,15
913,바로,2,2,2,2,8
914,단지,2,2,1,1,6
915,수익률,2,2,6,1,11
916,적금,2,1,4,1,8
917,구제,2,2,3,2,9
918,국내외,2,1,2,1,6
919,대화,2,4,2,5,13
920,전량,2,2,1,1,6
921,방북,2,2,1,1,6
922,주요,2,5,4,1,12
923,협업,2,1,3,1,7
924,풍선,2,1,2,1,6
925,결론,2,5,4,3,14
926,금융위기,2,2,2,3,9
927,채널,2,1,1,2,6
928,리더,2,3,2,1,8
929,체계,2,6,6,2,16
930,투쟁,2,1,2,3,8
931,단기,2,3,3,4,12
932,엔진,2,3,4,1,10
933,조건,2,2,2,3,9
934,세븐일레븐,2,1,1,2,6
935,하늘,2,1,5,3,11
936,대학,2,4,4,2,12
937,통신비,2,1,1,1,5
938,법인,2,6,5,7,20
939,주문,2,3,2,2,9
940,전체,2,7,6,2,17
941,신뢰,2,5,5,2,14
942,누적,2,1,3,2,8
943,역사,2,5,2,1,10
944,근로자,2,6,8,4,20
945,실현,2,2,1,2,7
946,훈풍,2,9,1,1,13
947,과제,2,6,5,3,16
948,여개,2,1,1,1,5
949,명중,2,2,3,2,9
950,업자,2,3,21,8,34
951,회계,2,5,4,5,16
952,급식,2,4,1,1,8
953,포항,2,1,1,1,5
954,아카데미,2,2,2,1,7
955,주거,2,3,4,1,10
956,출산,2,2,1,2,7
957,경쟁력,2,3,9,3,17
958,가게,2,1,2,1,6
959,상용,2,5,2,1,10
960,기한,2,1,4,2,9
961,내부,2,6,4,3,15
962,차등,2,2,9,3,16
963,택지,2,1,6,2,11
964,케미칼,2,3,3,1,9
965,사건,2,4,2,1,9
966,리콜,2,1,11,4,18
967,홀로,2,2,1,1,6
968,직구,2,1,6,3,12
969,근로,2,9,11,5,27
970,다른,2,2,1,1,6
971,불참,2,2,1,1,6
972,주도,2,3,24,1,30
973,사직,2,1,1,1,5
974,집단소송,2,1,3,1,7
975,소비자원,2,3,5,2,12
976,와인,2,1,1,2,6
977,연기,2,3,2,3,10
978,상속,2,2,1,2,7
979,회원,2,2,1,2,7
980,보증,2,3,5,7,17
981,탐색,2,6,4,9,21
982,축산물,2,2,2,1,7
983,콜러,2,3,1,3,9
984,완전,2,2,1,1,6
985,공급,2,8,22,9,41
986,수도권,2,3,7,3,15
987,이전,2,4,2,1,9
988,공원,2,1,4,4,11
989,향상,2,3,2,2,9
990,배당,2,10,5,2,19
991,노동,2,4,3,2,11
992,조작,2,14,3,2,21
993,지출,2,1,4,1,8
994,페어,2,1,3,2,8
995,유해,2,5,1,1,9
996,전기차,2,3,8,1,14
997,수소,2,2,5,2,11
998,종부세,2,5,17,3,27
999,단독,2,3,3,1,9
1000,아시아,2,2,2,3,9
1001,보증금,2,1,3,1,7
1002,교통,2,2,3,3,10
1003,역량,2,5,5,3,15
1004,신기록,2,6,6,4,18
1005,우드,2,4,1,1,8
1006,펀딩,2,4,1,1,8
1007,운행,2,5,7,4,18
1008,법원,2,6,4,1,13
1009,불과,2,2,2,2,8
1010,판매량,2,1,2,1,6
1011,완료,2,2,4,4,12
1012,단가,2,2,2,2,8
1013,제로,2,3,2,3,10
1014,예방,2,1,2,2,7
1015,즉시,2,5,15,3,25
1016,열차,2,4,1,1,8
1017,기아차,2,3,8,5,18
1018,설비,2,7,5,2,16
1019,위축,2,4,3,1,10
1020,하이닉스,2,2,4,1,9
1021,신용등급,2,3,1,3,9
1022,제기,2,1,3,2,8
1023,하위,2,3,5,1,11
1024,점진,2,2,1,2,7
1025,방침,2,1,2,1,6
1026,언급,2,2,2,1,7
1027,상향,2,1,6,1,10
1028,상장,2,2,2,1,7
1029,무료,2,2,14,5,23
1030,주가,2,6,5,6,19
1031,바닥,2,2,2,2,8
1032,최태원,2,2,5,1,10
1033,우체국,2,4,4,4,14
1034,다이어트,2,3,1,1,7
1035,지자체,2,2,3,2,9
1036,대처,2,2,1,1,6
1037,항공권,1,1,1,1,4
1038,무슨,1,1,1,1,4
1039,종료,1,2,5,1,9
1040,여의도,1,2,4,2,9
1041,자체,1,1,2,1,5
1042,노선,1,4,4,4,13
1043,주식시장,1,1,1,2,5
1044,플랜트,1,2,3,2,8
1045,마켓,1,2,6,2,11
1046,주유소,1,4,2,5,12
1047,만들기,1,1,2,2,6
1048,신속,1,2,2,1,6
1049,텔레콤,1,4,3,3,11
1050,정비,1,3,8,1,13
1051,청소,1,1,1,1,4
1052,연내,1,3,7,3,14
1053,동시,1,3,3,1,8
1054,접종,1,1,1,2,5
1055,허가,1,5,2,2,10
1056,변경,1,7,5,1,14
1057,솔솔,1,1,1,1,4
1058,피케,1,1,1,1,4
1059,나무,1,1,2,1,5
1060,보수,1,1,1,4,7
1061,연구개발,1,3,2,2,8
1062,양극화,1,5,4,2,12
1063,공모,1,7,4,2,14
1064,데이터,1,4,4,6,15
1065,주스,1,1,1,1,4
1066,거취,1,2,2,1,6
1067,청춘,1,2,1,1,5
1068,경제성장률,1,2,4,4,11
1069,안정화,1,1,2,1,5
1070,핑크,1,2,2,1,6
1071,발언,1,1,2,2,6
1072,가로,1,3,1,2,7
1073,걸음,1,1,3,1,6
1074,생계,1,2,1,1,5
1075,시민,1,3,4,1,9
1076,공익,1,4,4,1,10
1077,진통,1,1,2,1,5
1078,하반기,1,4,29,3,37
1079,코엑스,1,2,2,1,6
1080,제철,1,1,1,1,4
1081,상호금융,1,4,6,2,13
1082,농촌,1,11,1,6,19
1083,유튜브,1,1,1,2,5
1084,블로그,1,1,2,1,5
1085,세로,1,3,1,1,6
1086,웰빙,1,1,2,1,5
1087,현지,1,3,3,1,8
1088,임시,1,4,1,1,7
1089,처방,1,1,4,2,8
1090,절벽,1,3,2,2,8
1091,굿네이버스,1,1,2,1,5
1092,서울시,1,4,4,2,11
1093,아동,1,5,10,5,21
1094,자리,1,6,7,3,17
1095,서류,1,4,1,1,7
1096,소재,1,1,1,1,4
1097,당신,1,1,2,1,5
1098,망치,1,1,1,2,5
1099,대국민,1,1,3,2,7
1100,전격,1,7,1,1,10
1101,선진국,1,2,4,1,8
1102,의료,1,6,3,3,13
1103,교환,1,1,2,1,5
1104,범위,1,1,1,1,4
1105,방한,1,1,1,1,4
1106,대치,1,1,3,1,6
1107,조선업,1,5,3,1,10
1108,한계,1,2,4,2,9
1109,우유,1,4,2,1,8
1110,방식,1,3,1,2,7
1111,인테리어,1,1,1,1,4
1112,동력,1,2,1,1,5
1113,캐나다,1,1,1,1,4
1114,유통업,1,2,5,1,9
1115,리나,1,1,3,2,7
1116,순이익,1,1,2,1,5
1117,구슬,1,1,1,2,5
1118,계절,1,1,2,1,5
1119,독립성,1,1,1,2,5
1120,불편,1,2,3,1,7
1121,품질,1,3,3,3,10
1122,다음주,1,1,2,1,5
1123,노후,1,4,3,2,10
1124,시즌,1,3,4,1,9
1125,페스티벌,1,2,2,1,6
1126,대로,1,1,3,1,6
1127,환자,1,1,18,2,22
1128,극복,1,3,4,2,10
1129,여건,1,3,1,1,6
1130,감리,1,7,6,1,15
1131,수정,1,1,4,1,7
1132,신한,1,1,2,1,5
1133,재기,1,1,1,1,4
1134,어워드,1,1,1,1,4
1135,의미,1,1,2,2,6
1136,허리,1,1,4,2,8
1137,처벌,1,5,2,3,11
1138,자영,1,1,17,6,25
1139,기금,1,2,4,7,14
1140,저축은행,1,4,5,4,14
1141,코드,1,2,10,1,14
1142,부업,1,2,1,1,5
1143,발의,1,2,1,1,5
1144,시사,1,1,2,1,5
1145,용품,1,2,4,1,8
1146,연구원,1,1,2,3,7
1147,제동,1,3,3,3,10
1148,심각,1,4,5,1,11
1149,시공,1,2,2,1,6
1150,억대,1,1,1,3,6
1151,증거,1,2,1,1,5
1152,한국인,1,2,2,1,6
1153,촉진,1,2,2,2,7
1154,용량,1,2,2,1,6
1155,줄줄이,1,4,4,3,12
1156,탄력,1,7,4,1,13
1157,물품,1,2,3,1,7
1158,법인세,1,2,2,1,6
1159,임기,1,2,1,1,5
1160,보험금,1,1,7,1,10
1161,주인,1,3,2,1,7
1162,잔치,1,2,1,1,5
1163,소형,1,4,2,1,8
1164,사료,1,2,2,1,6
1165,화재,1,3,13,5,22
1166,상대,1,2,1,2,6
1167,닉스,1,2,3,1,7
1168,프리,1,1,1,1,4
1169,리뉴얼,1,7,1,1,10
1170,고의,1,1,6,4,12
1171,자연,1,3,1,1,6
1172,제조,1,1,2,2,6
1173,기사,1,2,4,2,9
1174,어려움,1,1,1,1,4
1175,불량,1,2,1,1,5
1176,마당,1,1,1,4,7
1177,작품,1,1,1,1,4
1178,급여,1,6,4,3,14
1179,유가,1,5,5,7,18
1180,점심,1,3,2,1,7
1181,차지,1,3,1,1,6
1182,소주,1,2,2,4,9
1183,분기,1,2,3,1,7
1184,과학기술,1,1,1,1,4
1185,분식회계,1,8,4,6,19
1186,메뉴,1,2,1,1,5
1187,뷰티,1,4,2,4,11
1188,이행,1,2,2,1,6
1189,아트,1,1,2,1,5
1190,취소,1,12,11,4,28
1191,이동,1,3,4,1,9
1192,인터넷,1,6,13,2,22
1193,방송,1,2,8,2,13
1194,론칭,1,6,2,2,11
1195,매트,1,3,2,2,8
1196,케어,1,4,3,5,13
1197,산학,1,1,2,1,5
1198,용액,1,1,1,1,4
1199,추징,1,1,3,1,6
1200,계단,1,1,2,1,5
1201,고액,1,1,3,1,6
1202,관세청,1,12,4,3,20
1203,제출,1,2,3,1,7
1204,비율,1,5,8,2,16
1205,등급,1,2,2,4,9
1206,정유,1,1,1,2,5
1207,개척,1,1,3,2,7
1208,자원,1,4,2,3,10
1209,고도화,1,1,1,1,4
1210,사무실,1,3,1,1,6
1211,무한,1,1,1,1,4
1212,배상,1,1,2,1,5
1213,자문,1,3,1,3,8
1214,불확실,1,4,7,2,14
1215,한류,1,1,2,2,6
1216,청약,1,5,6,2,14
1217,금융기관,1,2,1,3,7
1218,뒷받침,1,1,1,1,4
1219,지갑,1,1,3,1,6
1220,크게,1,4,4,1,10
1221,실제,1,1,1,2,5
1222,산다,1,1,1,2,5
1223,축제,1,3,5,4,13
1224,상임,1,1,2,1,5
1225,콘텐츠,1,5,12,3,21
1226,결합,1,1,3,3,8
1227,코스,1,3,3,1,8
1228,심사,1,3,1,1,6
1229,본점,1,1,1,1,4
1230,경험,1,2,2,2,7
1231,분리,1,1,12,5,19
1232,진흥,1,4,10,3,18
1233,동행,1,3,2,4,10
1234,포럼,1,2,1,4,8
1235,의결,1,1,3,1,6
1236,마약,1,1,1,1,4
1237,미지수,1,1,2,1,5
1238,자동,1,1,4,1,7
1239,경제부총리,1,4,1,1,7
1240,세미나,1,3,3,1,8
1241,지시,1,4,2,1,8
1242,원인,1,3,6,4,14
1243,실업자,1,6,7,6,20
1244,조업,1,1,2,4,8
1245,손님,1,2,1,3,7
1246,손해,1,8,4,2,15
1247,연대,1,1,4,1,7
1248,과일,1,2,3,1,7
1249,음료,1,4,1,1,7
1250,스쿨,1,3,1,1,6
1251,스타일,1,1,2,1,5
1252,다지,1,1,2,1,5
1253,디스플레이,1,2,2,2,7
1254,혐의,1,20,5,4,30
1255,울상,1,2,1,1,5
1256,인생,1,1,1,2,5
1257,콘서트,1,2,3,1,7
1258,날개,1,4,4,2,11
1259,송금,1,2,5,2,10
1260,부족,1,2,8,1,12
1261,미스터리,1,3,1,1,6
1262,홍콩,1,2,3,4,10
1263,몰이,1,1,1,1,4
