,단어명,정치1분기빈도수,정치2분기빈도수,정치3분기빈도수,정치4분기빈도수,총빈도수
0,홍준표,114,147,34,49,344
4,민주,104,116,65,21,306
17,국회,65,113,75,44,297
12,여야,73,70,72,28,243
21,민주당,58,115,53,12,238
911,드루,1,195,34,1,231
10,남북,82,62,63,18,225
6,수사,100,77,39,4,220
7,국민,99,66,38,17,220
18,평화,62,92,45,17,216
43,김성태,37,99,52,23,211
3,의혹,106,52,38,14,210
195,이재명,13,102,46,44,205
24,총리,55,56,45,37,193
46,선언,36,64,63,27,190
2,검찰,108,54,18,2,182
25,선거,50,104,11,14,179
19,회담,61,79,25,9,174
16,박근혜,67,67,22,18,174
20,안철수,61,92,16,2,171
8,출마,93,52,23,3,171
15,지방선거,68,91,2,2,163
42,논란,37,55,35,24,151
22,국정,58,36,33,20,147
5,개헌,100,36,9,1,146
9,조사,82,33,17,10,142
124,경제,18,33,49,42,142
1,안희정,109,9,15,1,134
64,김정은,27,55,27,22,131
72,정책,25,27,41,38,131
37,지지율,39,29,48,9,125
40,재판,38,47,17,21,123
66,북미,27,64,15,15,121
44,경찰,37,49,10,20,116
14,국정원,71,22,16,7,116
252,노회찬,11,9,93,1,114
95,박원순,21,76,13,3,113
55,발언,31,30,18,31,110
89,댓글,22,78,7,1,108
77,문재인,24,39,22,20,105
41,사퇴,38,53,8,5,104
30,특활비,41,11,43,9,104
134,정상회담,17,51,26,8,102
48,논의,34,35,20,13,102
63,합의,27,29,29,15,100
116,보수,18,42,13,26,99
92,장관,22,13,44,20,99
29,대책,44,15,22,14,95
135,비핵화,17,28,37,12,94
151,평양,16,9,46,22,93
203,인사,13,22,43,15,93
82,문제,24,36,24,8,92
13,통합,72,8,5,7,92
62,지사,28,41,16,6,91
11,구속,73,10,3,4,90
38,검토,38,14,20,17,89
239,일자리,11,27,24,26,88
118,위원장,18,20,43,7,88
56,정의당,30,17,35,4,86
79,요구,24,36,16,9,85
27,유승민,48,25,9,2,84
23,정당,58,11,9,5,83
28,발의,48,11,16,6,81
57,사건,30,36,7,8,81
49,사실,34,29,13,4,80
59,회의,30,18,15,16,79
32,서울시장,40,37,1,1,79
69,정권,26,30,9,14,79
287,판문점,10,34,27,7,78
395,성장,7,10,45,15,77
76,트럼프,24,37,10,6,77
173,남북정상회담,14,44,16,2,76
36,출석,39,19,10,7,75
126,개혁,18,17,27,13,75
34,혐의,40,22,11,1,74
31,대화,41,15,10,7,73
119,한반도,18,34,12,9,73
74,박지원,25,11,12,25,73
112,방문,19,15,20,18,72
121,혁신,18,18,28,8,72
437,조작,6,54,5,6,71
35,이명박,39,19,1,11,70
148,지원,16,28,20,6,70
125,임종석,18,10,14,28,70
674,소득,3,17,42,7,69
50,결정,34,15,14,6,69
109,처리,19,35,10,5,69
75,반대,25,19,18,6,68
1010,김문수,1,59,4,4,68
146,공개,16,28,13,11,68
52,뇌물,34,22,7,5,68
33,입장,40,20,5,3,68
80,농단,24,19,16,8,67
83,징역,24,27,5,10,66
155,최저임금,16,19,24,7,66
1002,손학규,1,16,20,29,66
96,발표,21,22,13,10,66
110,결과,19,27,14,5,65
39,대북,38,10,9,8,65
394,주도,7,11,33,13,64
147,비판,16,17,18,13,64
61,공동,28,8,15,13,64
85,관련,24,16,18,5,63
100,책임,21,23,14,5,63
65,협의,27,11,15,9,62
149,야당,16,22,19,5,62
932,홍영표,1,17,28,16,62
153,하락,16,11,25,10,62
88,사과,22,20,7,13,62
122,위해,18,19,16,8,61
184,규제,14,11,28,7,60
114,협상,18,32,9,1,60
90,선고,22,19,14,5,60
71,참석,26,11,13,10,60
348,하태경,8,8,19,25,60
54,북한,34,15,10,1,60
84,대응,24,16,15,4,59
53,소환,34,9,14,1,58
58,가능성,30,15,9,4,58
397,정상,7,25,20,5,57
70,보고,26,12,15,4,57
157,우리,15,23,14,5,57
133,필요,17,11,20,9,57
129,여사,17,18,11,10,56
99,국가,21,9,20,6,56
117,공천,18,27,9,2,56
539,고발,5,33,6,11,55
26,미투,50,2,2,1,55
132,요청,17,12,20,6,55
106,하나,20,10,10,14,54
150,협력,16,17,9,11,53
194,정의,13,25,11,4,53
158,구성,15,15,18,5,53
172,최고,14,15,18,6,53
267,대선,10,35,5,3,53
51,권력,34,13,3,2,52
292,확대,9,17,16,10,52
250,사람,11,19,11,11,52
108,확인,19,18,10,5,52
87,불법,23,10,9,10,52
103,지역,20,12,14,6,52
81,자금,24,10,11,6,51
242,역사,11,24,9,7,51
735,김동연,2,3,15,31,51
193,시장,13,28,7,2,50
198,정미,13,11,21,5,50
152,공무원,16,13,13,8,50
164,법원,15,13,6,15,49
264,국회의원,10,27,9,3,49
216,원내대표,12,22,12,3,49
930,예산,1,11,15,22,49
123,준비,18,18,6,7,49
67,인정,26,10,10,3,49
632,고용,4,5,18,22,49
47,김영철,35,5,7,1,48
45,성폭행,37,5,2,4,48
401,교체,7,9,15,16,47
338,원희룡,8,33,4,2,47
137,사회,17,3,22,5,47
326,뉴스,8,14,8,17,47
68,관계,26,11,5,5,47
319,민생,9,19,15,3,46
102,시간,20,11,10,5,46
249,방북,11,5,19,11,46
128,정치권,17,9,14,6,46
130,세월호,17,16,8,5,46
120,주장,18,14,9,5,46
91,보도,22,13,10,1,46
197,기대,13,16,12,4,45
144,부인,16,13,5,11,45
101,압수수색,20,6,14,5,45
232,특별,12,2,12,19,45
174,전략,14,21,2,8,45
246,조명,11,7,6,21,45
98,생각,21,11,5,8,45
996,당권,1,12,29,2,44
224,지지도,12,7,15,10,44
283,모두,10,16,10,8,44
145,지지,16,15,10,3,44
136,거부,17,15,10,2,44
111,취소,19,18,4,3,44
167,한미,15,16,7,6,44
156,전대,16,5,21,2,44
86,추가,23,13,7,1,44
404,공약,7,27,8,1,43
210,안보,13,20,8,2,43
236,계속,11,21,5,6,43
462,당선,6,34,2,1,43
163,일정,15,14,13,1,43
362,처벌,8,17,13,5,43
223,촉구,12,17,9,5,43
185,개입,14,15,13,1,43
181,탄핵,14,3,7,19,43
60,심사,28,6,5,4,43
78,여부,24,12,6,1,43
285,기관,10,18,11,4,43
613,선관위,4,34,3,1,42
113,경기,19,14,5,4,42
411,임명,7,9,8,18,42
307,폐지,9,7,23,3,42
384,이낙연,7,8,13,14,42
154,공세,16,19,5,2,42
240,청산,11,14,11,6,42
208,외교,13,17,9,3,42
161,개선,15,7,15,4,41
160,자유,15,19,4,3,41
73,고위,25,5,2,9,41
363,조치,8,11,17,5,41
619,노무현,4,17,13,7,41
884,비준,1,2,19,18,40
180,예정,14,15,8,3,40
227,법안,12,9,16,3,40
104,환영,20,9,9,2,40
94,재산,21,11,5,2,39
138,행사,17,13,3,6,39
93,의원직,22,11,5,1,39
293,위반,9,13,13,3,38
165,헌법,15,15,3,5,38
217,제안,12,14,8,3,37
505,이상,5,8,17,7,37
209,성과,13,8,10,6,37
159,적폐,15,10,7,5,37
345,본격,8,13,8,8,37
177,사용,14,9,6,8,37
322,도전,9,15,11,1,36
222,속도,12,8,11,5,36
272,의장,10,2,22,2,36
424,삼성,7,15,12,2,36
705,진보,3,13,15,5,36
175,우려,14,8,7,7,36
379,갈등,7,7,17,5,36
169,탈당,15,15,3,3,36
186,해결,14,13,5,4,36
202,비리,13,7,1,15,36
127,당원,18,7,8,2,35
361,진실,8,18,5,4,35
368,위원,8,6,17,4,35
392,평가,7,12,10,6,35
179,지방,14,11,8,2,35
238,주목,11,8,12,4,35
415,실장,7,4,9,15,35
412,친박,7,15,2,11,35
230,오찬,12,8,11,3,34
233,수석,12,8,6,8,34
168,지시,15,10,6,3,34
643,대위,3,15,9,7,34
97,청구,21,7,4,2,34
192,비난,13,8,8,5,34
527,방안,5,16,9,4,34
519,취임,5,13,12,4,34
200,강화,13,7,10,4,34
448,전두환,6,10,14,4,34
433,출신,6,9,12,7,34
213,위기,12,7,10,4,33
706,정상화,3,23,5,2,33
780,스캔들,2,27,3,1,33
178,운영,14,6,8,5,33
225,인상,12,3,12,6,33
449,역대,6,16,8,3,33
211,감사,13,6,6,8,33
561,최저,5,4,23,1,33
300,미국,9,11,9,4,33
207,의지,13,10,8,2,33
484,여성,6,10,14,3,33
299,선택,9,16,7,1,33
201,대한민국,13,9,9,2,33
477,동의,6,4,14,8,32
317,최선,9,9,9,5,32
428,가짜,6,6,5,15,32
221,개최,12,8,6,6,32
191,반발,13,10,3,6,32
131,청년,17,4,8,3,32
342,돌입,8,16,5,3,32
261,예고,10,12,7,3,32
570,청문회,4,2,19,7,32
199,핵심,13,7,5,7,32
365,나라,8,13,10,1,32
469,단체,6,19,4,3,32
626,국방,4,2,19,7,32
115,압박,18,7,3,4,32
711,장하,3,1,14,14,32
266,해명,10,14,4,4,32
270,회복,10,6,12,4,32
356,채용,8,7,7,9,31
557,정청,5,8,16,2,31
372,기간,7,10,10,4,31
328,무산,8,20,2,1,31
386,시대,7,13,7,4,31
393,도부,7,14,9,1,31
297,의결,9,12,6,4,31
350,포함,8,11,11,1,31
275,체제,10,17,3,1,31
219,제출,12,7,7,5,31
254,예비,11,18,1,1,31
205,전달,13,8,6,4,31
171,사고,14,6,8,3,31
204,수도,13,12,3,3,31
234,수사권,11,17,1,2,31
212,이재용,13,5,12,1,31
196,판결,13,5,2,10,30
276,싸움,10,10,7,3,30
495,김무성,6,8,8,8,30
107,접촉,20,6,2,2,30
260,노력,10,11,7,2,30
176,카드,14,4,7,5,30
257,나경원,11,11,2,6,30
274,이후,10,13,5,2,30
284,사태,10,5,8,7,30
373,실패,7,14,6,3,30
589,김정숙,4,6,11,9,30
487,계획,6,8,13,3,30
913,출장,1,23,4,2,30
383,동시,7,12,3,8,30
586,본회의,4,21,4,1,30
541,규명,5,13,10,1,29
183,공식,14,10,4,1,29
382,가능,7,17,3,2,29
349,반응,8,10,7,4,29
142,사찰,17,5,4,3,29
708,효과,3,9,12,5,29
460,완화,6,4,16,3,29
327,조정,8,13,4,4,29
357,과거,8,13,5,3,29
162,상승,15,8,2,4,29
435,주의,6,5,13,5,29
399,산업,7,7,7,7,28
957,단독,1,17,2,8,28
263,강조,10,3,11,4,28
277,직원,10,5,6,7,28
259,전쟁,10,8,3,7,28
434,막말,6,11,4,7,28
105,성폭력,20,3,4,1,28
309,행위,9,10,3,6,28
332,업무,8,7,9,4,28
355,부정,8,11,6,3,28
571,후보자,4,4,15,5,28
170,안전,15,6,4,3,28
341,나선,8,11,8,1,28
464,목소리,6,8,10,3,27
364,총선,8,9,7,3,27
253,적극,11,5,7,4,27
243,정신,11,7,3,6,27
312,연기,9,8,4,6,27
543,판단,5,14,5,3,27
278,의미,10,5,6,6,27
318,현장,9,5,8,4,26
247,개편,11,6,6,3,26
226,중앙,12,9,2,3,26
847,주자,2,6,17,1,26
339,모든,8,8,7,3,26
220,통과,12,5,7,2,26
189,질문,14,6,3,3,26
231,착수,12,8,3,3,26
166,구형,15,6,4,1,26
518,수용,5,18,1,2,26
635,다음,4,12,6,3,25
787,사법,2,5,12,6,25
492,송영,6,1,17,1,25
788,친문,2,7,15,1,25
255,신청,11,6,4,4,25
218,긍정,12,5,5,3,25
582,부대,4,2,2,17,25
308,감사원,9,5,7,4,25
244,시기,11,5,8,1,25
182,관리,14,3,7,1,25
649,인천,3,19,1,2,25
585,박정희,4,3,13,5,25
945,이행,1,13,6,5,25
782,태극기,2,1,2,20,25
241,좌파,11,2,3,9,25
396,포기,7,11,2,5,25
488,진행,6,11,6,2,25
358,피해,8,3,10,4,25
141,점검,17,4,2,2,25
273,다른,10,9,5,1,25
251,먼저,11,3,5,5,24
420,통일,7,8,8,1,24
245,가족,11,6,3,4,24
294,철회,9,11,2,2,24
390,연루,7,9,7,1,24
391,가장,7,10,6,1,24
568,교육,4,9,7,4,24
587,연속,4,2,14,4,24
289,여당,9,8,4,3,24
458,쟁점,6,12,5,1,24
315,기회,9,7,2,6,24
478,개정,6,9,6,3,24
351,상황,8,6,5,5,24
228,불참,12,7,2,3,24
187,도착,14,1,7,2,24
442,중요,6,8,9,1,24
765,해외,2,15,5,2,24
310,전문,9,5,9,1,24
486,문정인,6,10,7,1,24
418,거래,7,8,5,4,24
793,보좌,2,11,9,2,24
282,운명,10,8,5,1,24
858,재정,1,6,14,2,23
760,검증,2,7,9,5,23
511,겨냥,5,10,4,4,23
235,징계,11,1,6,5,23
237,증거,11,9,2,1,23
336,선물,8,4,8,3,23
143,피해자,16,2,2,3,23
288,초청,10,5,6,2,23
286,차관,10,3,9,1,23
303,집권,9,3,9,2,23
305,고민,9,7,5,2,23
313,충돌,9,7,2,5,23
634,속보,4,9,6,4,23
330,활동,8,6,5,4,23
271,약속,10,6,4,3,23
525,외교부,5,3,4,11,23
268,기자,10,5,5,3,23
472,복귀,6,5,10,2,23
422,과제,7,6,8,2,23
258,선수,11,1,7,4,23
366,금지,8,10,4,1,23
466,잡기,6,11,2,4,23
456,정보,6,2,10,5,23
522,채택,5,4,10,4,23
290,강행,9,7,1,6,23
190,연대,13,2,2,5,22
446,변호사,6,7,8,1,22
722,개정안,3,8,10,1,22
660,추천,3,12,6,1,22
491,기념,6,10,3,3,22
430,도지사,6,7,5,4,22
291,적용,9,1,6,6,22
256,제재,11,4,6,1,22
139,운동,17,1,3,1,22
556,김진태,5,4,6,7,22
353,통해,8,3,5,6,22
269,일부,10,5,5,2,22
867,연설,1,2,14,5,22
499,언론,6,7,6,2,21
848,유세,2,17,1,1,21
496,지속,6,5,7,3,21
321,제기,9,6,5,1,21
381,참여,7,6,5,3,21
298,정면,9,8,2,2,21
346,주말,8,9,3,1,21
578,경쟁,4,8,7,2,21
323,출범,9,7,3,2,21
603,어디,4,7,5,5,21
296,국무회의,9,5,5,2,21
506,심판,5,12,1,3,21
426,행보,7,6,6,2,21
215,원칙,12,5,3,1,21
409,하라,7,7,3,4,21
441,방송,6,8,5,2,21
602,도입,4,8,5,4,21
140,예술,17,2,1,1,21
516,참배,5,5,10,1,21
432,세력,6,8,2,5,21
343,동반,8,4,7,2,21
844,부동산,2,3,14,2,21
419,마음,7,5,8,1,21
425,상실,7,4,8,2,21
281,정국,10,7,1,2,20
809,의심,2,9,5,4,20
485,영향,6,7,5,2,20
689,역할,3,9,4,4,20
475,표명,6,11,1,2,20
265,안해,10,2,5,3,20
347,찬성,8,8,2,2,20
468,허위,6,8,3,3,20
562,최소,5,9,4,2,20
262,유지,10,4,5,1,20
302,촛불,9,2,4,5,20
370,유출,8,1,7,4,20
509,예상,5,12,1,2,20
414,목표,7,6,4,3,20
408,변화,7,8,2,3,20
885,황교안,1,1,4,14,20
607,심상정,4,8,6,2,20
566,신임,5,2,10,3,20
547,인권,5,7,5,3,20
550,방향,5,7,7,1,20
982,공공기관,1,1,11,7,20
376,반드시,7,6,5,2,20
553,전환,5,7,6,2,20
371,이슈,7,9,2,2,20
463,누가,6,7,4,3,20
304,여론,9,6,2,2,19
551,현실,5,9,4,1,19
316,강원랜드,9,5,3,2,19
314,중진,9,6,3,1,19
795,대결,2,10,5,2,19
334,공감,8,4,3,4,19
534,범죄,5,6,4,4,19
572,강남,4,10,3,2,19
229,통일부,12,2,3,2,19
440,유감,6,6,2,5,19
407,반성,7,6,3,3,19
387,이틀,7,9,2,1,19
248,공연,11,2,3,3,19
344,주재,8,4,5,2,19
910,의안,1,14,3,1,19
375,공직자,7,6,3,3,19
929,보장,1,7,10,1,19
467,불발,6,5,6,2,19
354,불가피,8,5,3,3,19
692,지금,3,6,4,6,19
188,폭로,14,2,2,1,19
535,선거법,5,6,5,2,18
579,전격,4,10,2,2,18
531,정의용,5,5,6,2,18
573,견제,4,10,3,1,18
544,처음,5,6,5,2,18
591,사업,4,2,6,6,18
549,주년,5,5,5,3,18
882,보고서,1,2,12,3,18
331,시도,8,7,1,2,18
359,기획,8,6,3,1,18
367,제한,8,5,4,1,18
374,때문,7,7,3,1,18
380,비공개,7,5,1,5,18
388,권한,7,5,4,2,18
895,이준석,1,7,7,3,18
410,아들,7,4,5,2,18
839,병원,2,11,3,2,18
775,지적,2,5,4,7,18
214,장제원,12,2,1,3,18
279,행정,10,4,3,1,18
451,인물,6,6,5,1,18
452,사망,6,1,9,2,18
206,수수,13,1,3,1,18
731,야권,2,11,2,3,18
726,공격,3,7,6,2,18
280,당론,10,4,1,3,18
311,정치인,9,4,3,2,18
301,거론,9,4,3,2,18
493,만찬,6,8,3,1,18
295,우선,9,2,6,1,18
352,고심,8,4,4,2,18
555,사법부,5,2,6,4,17
969,음주운전,1,2,2,12,17
552,마무리,5,4,7,1,17
597,제도,4,3,8,2,17
948,범위,1,11,4,1,17
598,독립,4,1,10,2,17
819,계파,2,5,8,2,17
750,환경,2,4,2,9,17
724,주기,3,7,5,2,17
673,탁현민,3,9,4,1,17
642,왜곡,3,8,4,2,17
640,수준,4,3,6,4,17
631,자리,4,5,7,1,17
836,조국,2,4,3,8,17
1015,방탄,1,12,2,2,17
360,대비,8,4,4,1,17
431,불가,6,5,4,2,17
436,기각,6,2,8,1,17
417,기준,7,4,2,4,17
320,아베,9,4,3,1,17
416,내용,7,4,5,1,17
413,전해철,7,3,4,3,17
521,등장,5,3,6,3,17
450,의문,6,6,2,3,17
403,소송,7,4,5,1,17
439,최종,6,8,1,2,17
614,잘못,4,1,6,5,16
727,종합,3,6,1,6,16
523,라며,5,5,4,2,16
905,인도,1,2,11,2,16
785,폭풍,2,6,6,2,16
398,절차,7,4,4,1,16
515,차단,5,8,2,1,16
455,강력,6,3,6,1,16
405,반박,7,1,7,1,16
608,토론,4,5,4,3,16
817,생중계,2,11,2,1,16
377,결심,7,6,2,1,16
508,정계,5,8,2,1,16
565,전당대회,5,4,6,1,16
683,취재,3,9,2,2,16
686,태풍,3,4,7,2,16
536,특혜,5,5,3,3,16
470,사전,6,4,3,3,16
461,의사,6,5,4,1,16
933,부적절,1,4,5,6,16
964,싱가포르,1,8,4,3,16
497,공모,6,7,2,1,16
716,항소,3,5,1,7,16
540,보호,5,2,6,3,16
719,자료,3,5,5,3,16
476,벌금,6,4,2,4,16
490,석방,6,7,2,1,16
528,꼼수,5,6,4,1,16
337,부처,8,1,2,5,16
994,입법,1,9,4,2,16
479,면제,6,2,5,2,15
811,총력,2,8,3,2,15
715,불복,3,7,1,4,15
718,경고,3,8,2,2,15
454,끝내,6,7,1,1,15
618,위장,4,5,4,2,15
723,전국,3,7,2,3,15
429,연장,6,1,6,2,15
489,언제,6,3,4,2,15
333,변호인,8,4,2,1,15
599,선출,4,8,1,2,15
423,남북관계,7,3,3,2,15
335,입당,8,4,1,2,15
483,경계,6,2,2,5,15
529,눈물,5,5,4,1,15
838,가동,2,7,5,1,15
325,발전,9,2,3,1,15
545,외면,5,5,4,1,15
369,대법원,8,2,2,3,15
1005,비용,1,5,5,4,15
532,종료,5,8,1,1,15
538,협조,5,4,3,3,15
583,가치,4,3,7,1,15
563,소통,5,2,5,3,15
690,서훈,3,4,6,1,14
814,자기,2,2,3,7,14
992,명예훼손,1,7,5,1,14
324,관람,9,1,3,1,14
306,판사,9,2,2,1,14
671,해소,3,2,7,2,14
666,유력,3,5,3,3,14
481,전면,6,3,3,2,14
676,구도,3,3,6,2,14
457,제시,6,3,3,2,14
954,해제,1,5,3,5,14
797,민주주의,2,5,3,4,14
378,신고,7,3,3,1,14
385,진술,7,5,1,1,14
906,여의도,1,4,3,6,14
737,깜짝,2,2,7,3,14
389,김태년,7,2,3,2,14
756,노동,2,4,5,3,14
443,대한,6,5,1,2,14
870,이름,1,7,3,3,14
784,정말,2,4,2,6,14
865,투쟁,1,9,3,1,14
438,일단,6,2,5,1,14
791,차기,2,5,3,4,14
421,공장,7,1,5,1,14
548,만남,5,5,3,1,14
512,전망,5,7,1,1,14
575,광역단체장,4,7,2,1,14
564,거취,5,5,3,1,14
530,방침,5,4,2,3,14
514,대치,5,6,2,1,14
526,내달,5,4,3,2,14
633,재단,4,4,4,2,14
560,신중,5,4,4,1,14
494,취업,6,1,6,1,14
517,설치,5,5,1,3,14
601,세상,4,5,4,1,14
502,공조,5,3,3,2,13
704,노조,3,3,2,5,13
444,항의,6,3,2,2,13
688,유엔,3,2,6,2,13
474,죄송,6,4,1,2,13
533,직무,5,5,2,1,13
961,공유,1,6,4,2,13
698,대립,3,5,3,2,13
569,안민석,4,2,3,4,13
406,계기,7,2,3,1,13
768,관심,2,1,6,4,13
471,조율,6,4,2,1,13
896,이견,1,3,4,5,13
445,조절,6,1,4,2,13
465,문화,6,2,1,4,13
710,민간,3,4,2,4,13
764,여권,2,5,4,2,13
340,구치소,8,3,1,1,13
501,상납,6,4,2,1,13
866,빈소,1,8,3,1,13
739,귀국,2,4,6,1,13
936,탄력,1,7,2,3,13
707,위로,3,4,4,2,13
658,주력,3,3,6,1,13
661,번영,3,5,4,1,13
558,성사,5,3,1,4,13
480,서울시,6,3,2,2,13
655,순방,3,1,1,8,13
427,정지,7,1,1,4,13
984,게임,1,2,6,4,13
672,세계,3,5,4,1,13
807,근로,2,3,4,4,13
584,원전,4,1,3,4,12
628,존중,4,5,2,1,12
662,동영상,3,3,3,3,12
659,시절,3,3,5,1,12
903,동맹,1,5,2,4,12
714,파일,3,7,1,1,12
871,완전,1,5,5,1,12
749,신설,2,2,6,2,12
934,위법,1,9,1,1,12
577,은퇴,4,5,2,1,12
914,페북,1,1,9,1,12
510,임박,5,1,4,2,12
653,조기,3,4,3,2,12
617,정무,4,4,3,1,12
609,철저,4,3,4,1,12
503,얘기,5,2,2,3,12
830,교류,2,4,4,2,12
616,내정,4,1,6,1,12
473,대처,6,1,3,2,12
639,자살,4,4,3,1,12
763,오른,2,5,4,1,12
682,기초,3,5,2,2,12
687,영상,3,4,2,3,12
893,애도,1,2,7,2,12
637,중심,4,5,1,2,12
329,즉각,8,2,1,1,12
595,자신,4,5,2,1,12
684,차원,3,5,3,1,12
402,공직,7,1,1,3,12
592,결론,4,6,1,1,12
892,사령관,1,5,5,1,12
668,방법,3,5,2,2,12
567,의견,4,1,4,3,12
834,허용,2,4,4,2,12
915,대권,1,5,3,2,11
400,대가,7,2,1,1,11
1011,건강,1,6,1,3,11
878,공사,1,3,2,5,11
610,시스템,4,1,3,3,11
646,수습,3,4,1,3,11
520,설명,5,2,2,2,11
611,김어준,4,3,2,2,11
742,공정,2,1,1,7,11
828,의회,2,4,2,3,11
524,권익위,5,2,2,2,11
581,기억,4,5,1,1,11
590,외부,4,5,1,1,11
652,동원,3,2,1,5,11
736,증가,2,2,2,5,11
757,고려,2,4,4,1,11
803,전문가,2,3,2,4,11
855,일침,2,2,2,5,11
498,류여해,6,1,1,3,11
593,정청래,4,4,1,2,11
669,안정,3,1,5,2,11
960,국토부,1,1,5,4,11
701,인식,3,4,2,2,11
986,연일,1,6,2,2,11
537,당시,5,2,3,1,11
802,정리,2,2,5,2,11
946,분야,1,2,3,5,11
734,안상수,2,4,2,3,11
713,작성,3,1,6,1,11
500,혼선,6,1,3,1,11
852,훼손,2,4,1,4,11
680,강경화,3,2,3,3,11
679,자격,3,3,2,3,11
792,신속,2,6,2,1,11
721,가나,3,4,3,1,11
459,시민단체,6,2,2,1,11
853,정우택,2,7,1,1,11
980,경제부총리,1,2,1,7,11
677,현직,3,4,1,3,11
620,곤란,4,3,1,3,11
789,사단,2,3,5,1,11
995,강제,1,1,4,5,11
630,상징,4,2,3,2,11
820,재난,2,3,4,1,10
774,정체,2,4,2,2,10
504,내주,5,2,2,1,10
596,무력,4,2,3,1,10
482,고개,6,1,1,2,10
860,방해,1,4,3,2,10
604,진짜,4,3,1,2,10
612,동참,4,1,2,3,10
546,일방,5,1,1,3,10
854,이산가족,2,2,5,1,10
790,제공,2,4,3,1,10
729,노총,3,1,3,3,10
874,혜원,1,1,1,7,10
622,최악,4,2,3,1,10
554,축하,5,2,2,1,10
648,의무,3,5,1,1,10
656,마치,3,3,3,1,10
990,특권,1,3,4,2,10
665,조만간,3,3,1,3,10
675,성범죄,3,1,2,4,10
975,세금,1,2,6,1,10
685,통제,3,3,3,1,10
693,하자,3,3,3,1,10
694,급등,3,1,4,2,10
881,원장,1,4,4,1,10
943,머리,1,3,4,2,10
937,당부,1,3,5,1,10
623,낙마,4,3,2,1,10
712,수락,3,2,4,1,10
621,엄중,4,3,1,2,10
447,얼굴,6,1,1,2,10
453,제왕,6,1,1,2,10
919,사의,1,5,3,1,10
918,실천,1,4,4,1,10
743,관건,2,4,3,1,10
615,일제,4,1,4,1,10
728,해당,3,4,1,2,10
831,정례,2,1,5,1,9
825,퇴장,2,4,1,2,9
542,비례대표,5,2,1,1,9
897,공방전,1,2,3,3,9
1000,환수,1,5,2,1,9
513,대국민,5,2,1,1,9
908,단계,1,1,5,2,9
856,제외,2,2,4,1,9
833,구축,2,4,1,2,9
985,부총리,1,1,2,5,9
580,무엇,4,1,2,2,9
965,목적,1,2,5,1,9
594,스스로,4,1,2,2,9
953,부담,1,2,5,1,9
928,발목,1,3,3,2,9
576,보기,4,2,2,1,9
829,시급,2,3,1,3,9
783,화해,2,3,3,1,9
636,악수,4,1,3,1,9
670,미흡,3,4,1,1,9
703,격려,3,2,2,2,9
700,비상,3,2,3,1,9
697,완성,3,4,1,1,9
507,시진핑,5,1,1,2,9
745,생활,2,4,2,1,9
681,관행,3,2,2,2,9
805,상대,2,5,1,1,9
747,대폭,2,2,4,1,9
627,통상,4,1,1,3,9
605,국정원장,4,3,1,1,9
606,선임,4,3,1,1,9
813,발끈,2,3,1,3,9
762,온도,2,4,2,1,9
769,무능,2,4,2,1,9
650,배제,3,2,1,3,9
770,눈길,2,3,1,3,9
779,뒷받침,2,2,3,2,9
645,초점,3,3,1,2,9
759,동안,2,1,4,1,8
625,체육,4,1,1,2,8
904,가야,1,4,1,2,8
730,극복,2,3,2,1,8
574,작년,4,1,2,1,8
717,지연,3,1,3,1,8
916,파탄,1,3,3,1,8
696,배치,3,3,1,1,8
702,주문,3,2,2,1,8
864,취하,1,1,1,5,8
695,폭력,3,2,2,1,8
629,구태,4,2,1,1,8
971,심각,1,2,3,2,8
678,용기,3,2,2,1,8
981,표현,1,1,4,2,8
983,근거,1,3,2,2,8
667,기도,3,1,2,2,8
991,명단,1,2,4,1,8
657,난항,3,1,2,2,8
559,신동빈,5,1,1,1,8
647,눈치,3,2,2,1,8
1006,발생,1,1,1,5,8
872,중도,1,5,1,1,8
641,여전,3,3,1,1,8
799,현역,2,1,4,1,8
821,분열,2,1,3,2,8
794,연결,2,1,3,2,8
843,도약,2,3,2,1,8
835,취약,2,1,3,2,8
822,기원,2,2,3,1,8
850,시동,2,2,3,1,8
600,전화,4,1,2,1,8
778,무슨,2,3,2,1,8
952,흐름,1,3,2,1,7
842,비율,2,2,2,1,7
947,집단,1,2,1,3,7
944,한국인,1,3,2,1,7
644,발족,3,2,1,1,7
798,깜깜,2,2,2,1,7
624,차질,4,1,1,1,7
720,달성,3,1,1,2,7
846,과태료,2,3,1,1,7
725,금융,3,1,1,2,7
733,접대,2,1,3,1,7
924,적임,1,3,2,1,7
740,주시,2,3,1,1,7
818,기조,2,1,3,1,7
744,사흘,2,3,1,1,7
950,교환,1,3,2,1,7
840,김명수,2,1,2,2,7
651,인력,3,1,2,1,7
699,예방,3,1,2,1,7
654,당일,3,2,1,1,7
663,심정,3,1,2,1,7
664,투입,3,1,2,1,7
988,표절,1,1,3,2,7
638,활성화,4,1,1,1,7
812,영광,2,2,2,1,7
810,도종환,2,1,1,3,7
804,실종,2,1,2,2,7
815,낭비,2,1,1,3,7
801,트랙,2,2,2,1,7
968,리더십,1,4,1,1,7
691,우린,3,2,1,1,7
837,광고,2,2,1,2,7
748,불평등,2,1,3,1,7
958,기금,1,2,2,2,7
861,화합,1,1,4,1,7
816,부실,2,1,2,2,7
876,집행,1,1,3,2,7
902,부당,1,1,4,1,7
755,질서,2,1,1,3,7
771,납득,2,1,3,1,7
859,참여연대,1,2,3,1,7
772,재건,2,3,1,1,7
877,릴레이,1,3,2,1,7
883,양극화,1,2,2,2,7
588,최후,4,1,1,1,7
868,사유,1,1,2,3,7
761,크게,2,3,1,1,7
773,라운드,2,2,1,2,7
777,지자체,2,2,2,1,7
890,발굴,1,2,3,1,7
754,망신,2,2,1,2,7
959,편성,1,2,1,2,6
766,찾기,2,1,2,1,6
963,특보,1,2,2,1,6
767,걱정,2,2,1,1,6
786,승진,2,2,1,1,6
781,움직임,2,2,1,1,6
966,태세,1,1,2,2,6
967,과연,1,1,2,2,6
972,회사,1,1,3,1,6
973,시점,1,3,1,1,6
800,저출산,2,2,1,1,6
977,조선,1,2,1,2,6
824,존재,2,1,1,2,6
863,결실,1,1,3,1,6
776,이익,2,1,1,2,6
1004,냉전,1,3,1,1,6
1003,다수,1,2,2,1,6
998,대감,1,1,3,1,6
997,시선,1,3,1,1,6
826,자처,2,1,1,2,6
832,단호,2,1,2,1,6
873,숙제,1,2,1,2,6
987,논문,1,1,2,2,6
827,육성,2,1,2,1,6
841,어린이집,2,1,2,1,6
808,실수,2,1,1,2,6
806,사임,2,2,1,1,6
955,기존,1,2,2,1,6
938,미소,1,2,1,2,6
900,표창원,1,2,2,1,6
922,사무소,1,1,3,1,6
845,대로,2,2,1,1,6
758,불허,2,1,2,1,6
935,번지,1,2,1,2,6
796,담당,2,1,1,2,6
917,인기,1,1,3,1,6
741,퇴진,2,2,1,1,6
753,아무,2,1,2,1,6
921,김상곤,1,1,2,2,6
894,악연,1,1,3,1,6
891,험로,1,2,2,1,6
709,답변,3,1,1,1,6
746,경험,2,1,2,1,6
909,아주,1,3,1,1,6
899,합리,1,1,2,2,6
926,돼지,1,2,1,1,5
951,부분,1,1,1,2,5
989,반격,1,1,1,2,5
888,명분,1,2,1,1,5
823,활용,2,1,1,1,5
993,후퇴,1,1,2,1,5
738,본질,2,1,1,1,5
901,그림자,1,2,1,1,5
849,취급,2,1,1,1,5
851,굴욕,2,1,1,1,5
1008,상대로,1,2,1,1,5
752,성격,2,1,1,1,5
732,사이버,2,1,1,1,5
751,출동,2,1,1,1,5
979,공백,1,2,1,1,5
857,김구,1,1,1,2,5
887,관광,1,1,2,1,5
889,유포,1,2,1,1,5
942,몰카,1,1,1,2,5
978,까닭,1,1,2,1,5
941,감소,1,1,2,1,5
940,최대한,1,1,2,1,5
862,전교조,1,2,1,1,5
962,초대,1,1,2,1,5
976,독대,1,1,2,1,5
970,출연,1,1,1,1,4
879,회고록,1,1,1,1,4
1014,계약,1,1,1,1,4
1013,동북아,1,1,1,1,4
1012,급증,1,1,1,1,4
931,적절,1,1,1,1,4
949,진위,1,1,1,1,4
1009,인연,1,1,1,1,4
886,편의,1,1,1,1,4
1007,편법,1,1,1,1,4
956,풀기,1,1,1,1,4
912,날개,1,1,1,1,4
875,포항,1,1,1,1,4
907,타격,1,1,1,1,4
1001,보전,1,1,1,1,4
869,위협,1,1,1,1,4
999,홍문표,1,1,1,1,4
898,음모,1,1,1,1,4
925,추측,1,1,1,1,4
974,기득권,1,1,1,1,4
939,제자리,1,1,1,1,4
923,금태섭,1,1,1,1,4
880,부위,1,1,1,1,4
920,이란,1,1,1,1,4
927,가중,1,1,1,1,4
