,단어명,사회1분기빈도수,사회2분기빈도수,사회3분기빈도수,사회4분기빈도수,총빈도수
0,경찰,264,354,324,187,1129
5,수사,177,189,191,81,638
7,의혹,172,147,166,75,560
22,폭행,87,188,110,140,525
3,검찰,188,155,111,68,522
1,조사,206,144,102,60,512
8,혐의,152,150,108,60,470
10,징역,140,136,142,45,463
13,여성,117,128,157,53,455
17,논란,102,111,132,84,429
12,구속,123,113,121,71,428
11,사망,129,90,112,57,388
21,사건,93,91,90,87,361
2,성추행,201,75,58,21,355
16,피해,111,79,92,55,337
38,재판,66,120,91,42,319
9,화재,143,39,63,62,307
4,병원,178,51,49,25,303
14,성폭행,114,95,56,30,295
26,살해,80,100,61,44,285
33,불법,71,76,91,45,283
28,영장,78,75,76,45,274
29,발견,77,64,90,39,270
34,직원,70,71,73,48,262
36,교사,68,62,90,40,260
25,피해자,82,75,39,64,260
6,미투,174,34,23,18,249
49,사고,57,62,79,36,234
27,압수수색,80,56,74,23,233
15,검사,112,57,45,15,229
23,소환,83,63,62,16,224
87,살인,41,33,57,92,223
18,일상,98,69,39,17,223
20,톡톡,97,75,32,17,221
40,법원,63,62,60,36,221
80,무죄,43,48,81,38,210
19,교수,98,60,31,21,210
63,검거,51,49,65,38,203
51,구속영장,55,68,47,32,202
47,출석,58,57,58,19,192
65,아파트,50,46,65,29,190
81,공개,43,51,46,48,188
45,현장,59,52,52,21,184
50,차량,56,45,58,22,181
76,처벌,44,44,53,37,178
67,학생,49,44,47,37,177
59,남성,51,46,48,32,177
58,신고,52,42,59,24,177
64,뉴스,51,65,38,23,177
474,몰카,13,77,65,18,173
121,흉기,35,60,42,36,173
70,공무원,46,45,48,34,173
56,환자,53,22,75,20,170
150,댓글,30,78,32,29,169
46,비리,58,29,27,52,166
91,국민,40,34,50,41,165
69,추가,47,52,48,16,163
101,학교,39,43,49,31,162
42,아들,60,33,43,22,158
89,변호사,41,35,50,30,156
48,세월호,57,64,29,5,155
484,유치원,13,6,44,92,155
109,주민,36,44,56,18,154
30,성폭력,77,37,18,19,151
105,문제,37,33,53,28,151
35,안희정,68,18,61,2,149
163,적발,29,33,53,34,149
103,체포,38,50,35,24,147
114,신청,36,55,28,28,147
73,입건,45,40,36,26,147
53,기자,54,39,33,20,146
43,채용,60,37,28,21,146
1195,이재명,5,9,68,63,145
100,남편,39,37,48,20,144
62,요구,51,37,40,16,144
82,아이,43,42,36,23,144
99,선고,39,45,42,17,143
206,범죄,24,28,48,43,143
144,인천,31,38,50,23,142
52,가족,55,36,28,22,141
147,거부,30,41,31,39,141
129,사회,33,52,37,18,140
55,기소,53,42,25,18,138
148,확인,30,54,37,15,136
95,안전,40,33,42,21,136
127,사기,34,23,60,17,134
79,업체,43,25,52,14,134
84,박근혜,42,53,27,11,133
60,아내,51,40,28,14,133
86,부인,42,39,32,20,133
312,실종,18,48,56,10,132
77,징역형,44,31,37,20,132
85,심사,42,34,36,18,130
132,단체,33,33,33,31,130
107,브리핑,37,53,30,9,129
143,지원,31,33,37,27,128
182,유출,27,27,52,21,127
94,경찰관,40,35,28,23,126
210,청원,23,27,37,39,126
39,미세먼지,65,31,10,20,126
116,판사,36,23,41,24,124
157,집단,29,45,31,19,124
111,사람,36,42,33,13,124
166,시신,29,39,37,19,124
24,참사,82,19,14,8,123
66,엄마,50,28,22,23,123
90,관련,41,38,29,15,123
31,국정원,75,30,13,4,122
115,시민,36,37,31,18,122
88,실형,41,25,37,18,121
54,청구,54,34,20,13,121
96,부상,40,38,31,12,121
501,조작,13,58,38,11,120
164,인정,29,36,27,26,118
1341,난민,5,27,68,17,117
93,간부,40,36,27,14,117
118,피의자,35,27,31,22,115
131,협박,33,30,26,24,113
211,고발,23,35,27,28,113
264,여고생,20,49,40,4,113
124,관리,34,36,27,15,112
1115,거래,6,53,42,10,111
179,노조,27,34,40,8,109
71,사실,46,24,25,14,109
260,기각,20,38,41,10,109
72,김현주,46,32,14,15,107
176,소송,28,29,28,21,106
245,취업,21,30,48,7,106
261,강제,20,27,29,30,106
171,교육,28,30,29,19,106
178,기사,27,34,28,16,105
189,사업,26,25,34,20,105
102,구조,38,23,32,11,104
122,전국,35,22,28,19,104
139,사장,32,23,31,17,103
218,송치,23,28,23,29,103
68,성희롱,48,24,23,8,103
130,긴급,33,31,28,10,102
106,검토,37,30,25,10,102
108,버스,37,21,30,14,102
191,모두,26,38,26,12,102
159,허위,29,27,31,14,101
215,집행유예,23,35,31,12,101
366,확대,16,29,41,14,100
92,항소심,40,32,18,10,100
98,사과,39,26,23,12,100
120,결정,35,16,33,15,99
169,대학,29,29,28,13,99
330,택시,17,21,21,40,99
232,반대,22,22,35,20,99
44,폭로,60,18,13,7,98
61,지진,51,22,12,13,98
117,구형,35,19,34,10,98
432,어린이집,14,25,40,19,98
431,음주운전,14,10,25,48,97
212,발생,23,16,48,10,97
104,책임,37,26,24,10,97
255,추락,20,28,29,19,96
374,추정,16,35,31,14,96
74,플러스,45,35,15,1,96
354,의심,16,17,46,15,94
125,징계,34,24,17,19,94
162,우리,29,26,22,17,94
407,영상,15,27,37,15,94
187,위해,26,38,17,12,93
161,중단,29,16,31,17,93
158,대응,29,24,30,10,93
321,삼성,18,37,30,8,93
32,세종,72,11,4,5,92
285,판결,19,19,35,18,91
167,서울시,29,19,20,23,91
134,가능성,32,23,27,9,91
185,의사,26,21,29,15,91
145,착수,30,22,32,7,91
505,집회,13,18,33,26,90
110,아버지,36,10,22,21,89
168,횡령,29,25,18,17,89
119,폐지,35,19,19,16,89
113,건물,36,26,21,5,88
766,촬영,9,27,38,14,88
200,주장,24,30,20,13,87
258,이상,20,16,26,25,87
41,제천,62,8,9,7,86
244,공사,21,22,21,22,86
236,우려,22,15,32,17,86
123,운영,34,10,30,12,86
112,의료,36,18,18,14,86
219,국내,23,21,23,18,85
153,인사,30,30,17,8,85
128,최저임금,34,23,25,3,85
360,최고,16,15,34,19,84
561,대상,12,23,33,16,84
235,증거,22,22,22,18,84
190,벌금형,26,19,23,14,82
138,대책,32,14,24,12,82
1171,메르스,6,1,69,6,82
463,운전자,13,16,29,24,82
199,세상,24,22,13,23,82
273,운전,19,16,28,18,81
180,확산,27,17,25,11,80
140,뇌물,32,26,14,8,80
37,다스,67,5,4,4,80
483,해외,13,25,33,9,80
203,집유,24,25,22,9,80
149,고소,30,19,21,10,80
276,판매,19,15,32,13,79
287,시도,19,31,18,11,79
356,위반,16,19,25,19,79
133,동료,33,18,20,8,79
222,벌금,23,22,22,12,79
135,취소,32,12,27,7,78
165,연기,29,12,27,10,78
345,장애인,17,27,16,18,78
207,결과,23,23,21,10,77
209,외국인,23,16,19,19,77
1588,양승태,4,22,29,22,77
248,필요,21,15,23,17,76
1092,만취,6,13,29,28,76
275,노인,19,21,21,15,76
177,성범죄,28,14,23,11,76
466,시위,13,23,29,10,75
433,대법,14,24,27,10,75
485,음주,13,18,26,18,75
137,유족,32,10,26,7,75
319,시설,18,22,22,13,75
286,상습,19,23,21,12,75
349,국가,17,15,25,18,75
333,의견,17,26,14,18,75
75,소방,44,9,13,9,75
606,청년,11,33,18,12,74
419,갈등,14,24,20,16,74
141,자금,32,12,26,4,74
292,발표,19,22,23,10,74
317,학대,18,16,27,13,74
204,차례,24,17,24,8,73
160,부장,29,9,19,16,73
172,아빠,28,11,20,14,73
213,단속,23,12,22,16,73
173,다른,28,22,17,6,73
309,사용,18,20,20,15,73
372,공장,16,21,20,15,72
205,현직,24,17,13,18,72
399,대법원,15,24,23,10,72
197,직장,25,19,16,11,71
242,소방관,21,17,27,6,71
195,비상,25,15,22,9,71
220,가해자,23,20,11,17,71
231,성매매,22,17,25,7,71
450,근로자,14,28,19,10,71
126,조치,34,13,15,9,71
253,금지,21,11,20,18,70
470,도주,13,20,21,16,70
194,기간,25,19,17,9,70
156,진상,29,21,15,5,70
241,부모,21,31,6,12,70
517,확정,12,24,19,15,70
233,보이스피싱,22,13,26,9,70
588,사법,11,13,22,24,70
284,도로,19,15,29,7,70
956,시험,7,18,23,22,70
405,고교,15,17,21,16,69
440,범행,14,19,21,15,69
268,학원,20,32,10,6,68
377,치료,16,20,18,14,68
472,반발,13,16,25,14,68
316,법정,18,19,25,6,68
214,일당,23,16,21,8,68
351,방치,17,15,24,12,68
313,지역,18,13,17,20,68
240,공항,22,13,32,1,68
216,화장실,23,17,19,8,67
444,하나,14,15,21,17,67
368,여부,16,14,25,12,67
1166,쓰레기,6,30,25,6,67
269,강화,20,14,20,13,67
352,설치,16,18,24,9,67
202,장관,24,15,19,9,67
151,대피,30,14,17,6,67
193,시간,25,15,23,4,67
396,절도,15,22,21,9,67
97,포항,39,11,15,2,67
394,학부모,15,6,17,28,66
416,유죄,14,18,23,11,66
278,투자,19,7,32,8,66
186,추행,26,15,19,6,66
221,여명,23,16,13,13,65
243,친구,21,12,21,11,65
290,아동,19,17,21,8,65
326,제자,17,27,14,7,65
320,업무,18,19,14,14,65
252,임금,21,24,15,5,65
344,청소년,17,18,22,8,65
498,마약,13,17,13,22,65
174,할머니,28,12,17,7,64
361,농단,16,13,15,20,64
57,이윤택,53,2,7,1,63
570,고용,12,28,15,8,63
383,정보,15,19,20,9,63
229,눈물,22,13,18,10,63
488,고속도로,13,16,21,13,63
336,센터,17,19,17,10,63
347,정황,17,13,21,12,63
198,진술,25,11,22,5,63
420,규명,14,20,19,10,63
298,합의,18,22,17,6,63
630,사법부,11,18,21,12,62
237,수색,22,23,14,3,62
230,출동,22,18,15,7,62
430,폭력,14,17,18,13,62
873,병역,8,12,13,29,62
154,결혼,29,9,15,8,61
267,중국,20,15,10,16,61
338,부부,17,18,15,11,61
325,교통사고,17,20,18,6,61
657,조폭,10,26,20,5,61
196,근무,25,20,12,4,61
618,유포,11,29,14,7,61
136,규모,32,12,9,7,60
554,대학생,12,19,19,10,60
155,운동,29,19,8,4,60
146,방화,30,15,11,4,60
251,어선,21,11,19,9,60
461,때문,13,18,17,12,60
346,강도,17,6,28,9,60
1024,증가,6,16,25,12,59
270,인권,20,14,18,7,59
442,문건,14,16,21,8,59
280,지시,19,13,19,8,59
459,가장,13,15,22,9,59
701,일부,9,17,24,9,59
754,가짜,9,10,24,16,59
353,부정,16,18,13,12,59
350,지사,17,3,28,10,58
453,성관계,14,20,15,9,58
78,화폐,44,7,4,3,58
2354,강진,1,37,19,1,58
456,확보,14,20,15,9,58
184,강원랜드,26,18,11,3,58
663,노동자,10,20,15,12,57
359,덜미,16,10,22,9,57
388,원인,15,12,17,13,57
402,서울대,15,17,23,2,57
437,주차,14,7,33,3,57
645,초등생,10,23,18,6,57
277,시장,19,8,17,13,57
224,금품,23,13,17,4,57
266,공작,20,13,15,9,57
300,집중,18,9,24,6,57
475,국회,13,18,17,8,56
308,출신,18,18,12,8,56
318,침해,18,15,14,9,56
175,사퇴,28,13,7,8,56
860,충돌,8,24,15,8,55
201,제출,24,11,12,8,55
589,이명박,11,19,14,11,55
358,계속,16,11,18,10,55
624,급증,11,9,22,12,54
954,촉구,7,22,15,10,54
566,경북,12,11,19,12,54
400,지하철,15,13,12,14,54
410,자녀,15,21,11,7,54
327,개혁,17,15,15,7,54
183,자살,26,16,6,6,54
595,유통,11,10,21,12,54
83,가상,42,8,1,3,54
332,가로,17,13,21,3,54
223,지휘,23,20,5,6,54
2328,혐오,1,6,37,9,53
301,관계,18,17,11,7,53
471,개선,13,22,11,7,53
304,법무부,18,18,13,4,53
256,여친,20,16,11,6,53
424,총장,14,20,14,5,53
152,귀가,30,11,6,6,53
295,동거,19,21,9,4,53
820,진행,8,19,17,9,53
729,선거,9,29,9,6,53
761,위기,9,11,21,12,53
329,본격,17,16,16,4,53
357,호소,16,12,14,11,53
378,역대,16,7,26,3,52
392,위협,15,12,16,9,52
170,사망자,29,9,8,6,52
506,개입,13,14,18,7,52
282,부실,19,13,10,10,52
310,작업,18,12,17,5,52
636,담배,10,19,17,6,52
720,헌재,9,14,23,5,51
496,원장,13,13,15,10,51
832,그룹,8,7,34,2,51
272,얼굴,19,14,11,7,51
239,모집,22,8,11,10,51
1168,양심,6,12,12,21,51
426,투신,14,8,22,7,51
441,청탁,14,21,15,1,51
753,속도,9,15,19,8,51
438,용의자,14,20,5,12,51
547,진실,12,12,17,10,51
324,주택,17,10,16,7,50
468,경찰청장,13,20,7,10,50
469,의식,13,18,14,5,50
699,모녀,10,33,4,3,50
861,제한,8,20,11,11,50
246,의무,21,10,10,9,50
341,단독,17,10,15,8,50
406,이용,15,14,16,5,50
477,불구속,13,23,8,6,50
522,대신,12,9,18,11,50
544,보험,12,6,17,15,50
549,마을,12,16,17,5,50
828,거리,8,19,17,6,50
311,주인,18,12,13,7,50
716,적용,9,18,14,9,50
809,특수,8,14,17,11,50
249,변호인,21,14,10,5,50
655,사태,10,15,15,10,50
389,시대,15,11,18,6,50
940,회사,7,17,17,9,50
535,기준,12,14,14,9,49
323,가능,17,16,12,4,49
734,장애,9,10,16,14,49
508,입원,12,12,14,11,49
411,이슈,14,21,5,9,49
1538,홍대,4,35,6,4,49
425,북한,14,19,11,5,49
181,극단,27,6,11,5,49
801,요청,8,18,17,6,49
294,인명,19,9,14,7,49
281,진화,19,12,11,7,49
525,처리,12,16,8,12,48
288,문화,19,12,7,10,48
511,비판,12,16,10,10,48
609,시민단체,11,15,15,7,48
640,건설,10,12,24,2,48
961,전자,7,13,19,9,48
536,광고,12,13,16,7,48
315,전직,18,10,14,6,48
369,건강,16,15,6,11,48
363,박원순,16,7,19,6,48
436,편의점,14,7,22,4,47
283,경비원,19,8,9,11,47
513,도심,12,12,14,9,47
495,해결,13,20,7,7,47
391,위험,15,12,13,7,47
539,무단,12,22,10,3,47
262,행위,20,9,8,10,47
550,훼손,12,8,16,11,47
742,주차장,9,9,25,4,47
557,미수,12,21,8,6,47
414,강요,14,14,7,12,47
791,동생,8,9,7,23,47
691,특별,10,8,21,8,47
621,동영상,11,13,9,14,47
362,사찰,16,15,10,6,47
439,상대,14,10,12,11,47
428,결론,14,15,12,6,47
480,자유,13,12,15,6,46
583,나선,11,19,12,4,46
217,무료,23,9,11,3,46
908,추적,7,15,16,8,46
447,감형,14,9,11,12,46
254,새벽,20,9,13,4,46
1354,예고,5,15,21,5,46
259,여자,20,11,12,3,46
1577,대란,4,25,13,4,46
952,목사,7,18,7,14,46
435,소환조사,14,12,15,5,46
305,모든,18,11,8,9,46
250,투입,21,12,11,2,46
257,보고,20,13,11,2,46
364,참여,16,11,13,6,46
853,교통,8,9,13,16,46
500,정책,13,11,13,9,46
614,이사장,11,25,6,3,45
486,머리,13,11,17,4,45
648,알바,10,17,16,2,45
821,과태료,8,18,11,8,45
398,경기,15,10,11,9,45
1361,석방,5,14,18,8,45
451,보수,14,12,7,12,45
748,강남,9,18,12,6,45
478,생각,13,12,16,4,45
565,세계,12,12,11,10,45
964,식약처,7,12,17,9,45
777,법정구속,9,11,14,11,45
365,선택,16,9,10,10,45
1148,폭발,6,25,4,10,45
1304,도박,5,12,17,11,45
412,남친,14,5,11,15,45
1974,난동,2,10,25,8,45
1154,공범,6,8,15,16,45
899,개최,7,16,16,5,44
746,사이트,9,11,18,6,44
1478,침대,4,33,6,1,44
574,항소,12,13,11,8,44
247,연장,21,5,13,5,44
1150,판단,6,15,15,8,44
373,승객,16,10,12,6,44
381,인상,16,10,5,13,44
735,사상,9,10,19,6,44
582,보호,11,10,12,11,44
620,어디,11,16,7,10,44
999,사립,7,1,1,35,44
521,제기,12,11,16,5,44
482,시행,13,11,14,6,44
208,남자,23,8,10,3,44
418,인근,14,11,16,3,44
497,준비,13,22,8,1,44
1221,택배,5,20,12,7,44
765,접촉,9,10,23,2,44
265,희생,20,12,8,4,44
303,합격,18,15,7,4,44
492,이틀,13,16,11,4,44
545,보상,12,7,11,13,43
328,발언,17,12,13,1,43
331,처분,17,5,12,9,43
649,규제,10,10,14,9,43
538,당국,12,7,16,8,43
627,부당,11,15,13,4,43
448,해고,14,16,7,6,43
1173,고교생,6,12,21,4,43
1111,행사,6,13,15,9,43
1058,물질,6,11,21,5,43
665,도입,10,11,14,8,43
1883,욕설,2,18,9,14,43
726,주의,9,16,12,6,43
335,국정,17,13,9,4,43
493,이후,13,10,10,9,42
537,철거,12,13,13,4,42
225,간호사,23,8,8,3,42
1545,평균,4,14,14,10,42
367,라며,16,15,9,2,42
234,재산,22,7,7,6,42
910,조정,7,20,10,5,42
397,자택,15,8,10,9,42
706,자료,9,8,18,7,42
610,배상,11,13,8,10,42
1155,붕괴,6,14,18,4,42
594,논의,11,10,15,6,42
188,인권위,26,7,6,3,42
938,운행,7,7,15,13,42
1061,노동,6,19,14,3,42
291,전원,19,10,11,2,42
491,수당,13,15,7,7,42
671,곳곳,10,14,10,7,41
1639,수능,3,7,5,26,41
2428,임종헌,1,1,8,31,41
322,감염,18,4,18,1,41
464,효과,13,7,15,6,41
607,희망,11,17,9,4,41
677,승용차,10,9,15,7,41
192,후배,25,6,6,4,41
704,절반,9,13,7,12,41
355,활동,16,14,10,1,41
460,사랑,13,15,8,5,41
1071,전쟁,6,13,18,4,41
263,미성년,20,11,5,5,41
421,기록,14,4,17,6,41
1732,건국대,3,8,26,3,40
882,마리,8,16,8,8,40
584,경찰청,11,7,13,9,40
279,방해,19,13,5,3,40
455,여중생,14,10,12,4,40
559,전남,12,3,14,11,40
446,문자,14,13,8,5,40
401,회의,15,9,11,5,40
510,일자리,12,4,17,7,40
307,특활비,18,5,16,1,40
499,명예훼손,13,12,12,3,40
737,행정,9,7,16,8,40
1465,공단,4,10,20,6,40
1781,수거,3,25,8,4,40
385,지금,15,11,12,2,40
534,카드,12,10,14,4,40
714,증언,9,9,13,9,40
678,고의,10,14,15,1,40
553,전북,12,4,16,8,40
306,위안부,18,10,6,6,40
719,기관,9,14,7,10,40
142,남매,32,2,3,2,39
586,어린이,11,6,16,6,39
289,해경,19,5,9,6,39
796,법무,8,24,5,2,39
1122,공원,6,6,21,6,39
709,서비스,9,14,7,9,39
778,당신,9,12,8,10,39
509,여학생,12,12,13,2,39
1674,국제,3,7,24,5,39
802,보도,8,12,8,11,39
518,돌파,12,7,11,9,39
227,서지현,23,11,1,4,39
526,탈출,12,6,15,6,39
386,호텔,15,14,3,7,39
650,모텔,10,11,11,7,39
238,폐쇄,22,8,7,2,39
710,바다,9,11,14,5,39
1004,파문,7,15,11,6,39
473,무더기,13,13,10,3,39
271,해임,20,5,11,3,39
465,대한민국,13,11,7,8,39
1180,김명수,6,18,8,6,38
762,지인,9,9,15,5,38
804,국민연금,8,5,18,7,38
637,한국인,10,9,8,11,38
661,이웃,10,13,12,3,38
841,음란,8,11,16,3,38
852,관심,8,10,14,6,38
343,사형,17,7,8,6,38
296,어머니,19,3,12,4,38
988,보육,7,7,16,8,38
573,출산,12,13,6,7,38
519,입장,12,11,12,3,38
516,조직,12,9,11,6,38
558,전문,12,7,10,9,38
542,광장,12,9,12,5,38
337,바람,17,8,7,6,38
564,주의보,12,7,16,3,38
528,점검,12,9,11,6,38
903,분노,7,11,7,13,38
415,과거,14,12,5,7,38
413,통보,14,8,10,6,38
546,방송,12,9,13,4,38
395,구치소,15,13,9,1,38
376,보복,16,11,7,4,38
933,전면,7,14,9,7,37
1500,소비자,4,8,18,7,37
552,몰래,12,8,12,5,37
608,수도,11,7,8,11,37
604,비정규직,11,12,10,4,37
934,정당,7,7,13,10,37
797,법인,8,17,7,5,37
502,해상,13,7,13,4,37
457,알바생,14,9,10,4,37
302,예비,18,13,3,3,37
1222,카페,5,9,5,18,37
384,관광객,15,6,9,7,37
556,죄송,12,16,3,6,37
512,죽음,12,8,11,6,37
833,상태,8,10,10,9,37
904,누리꾼,7,13,9,8,37
603,충북,11,8,12,6,37
638,문재인,10,7,13,6,36
1174,급여,6,9,13,8,36
434,예정,14,5,11,6,36
593,현금,11,4,17,4,36
966,취해,7,5,14,10,36
681,헬기,10,13,8,5,36
404,교육감,15,9,3,9,36
2304,징용,1,6,7,22,36
1070,등장,6,11,17,2,36
379,차별,16,9,6,5,36
1814,강용석,3,1,13,19,36
228,블랙리스트,23,8,3,2,36
1717,제품,3,8,18,7,36
602,교육부,11,12,7,5,35
879,직장인,8,12,7,8,35
1548,축제,4,6,14,11,35
340,전환,17,4,9,5,35
1987,대법관,2,10,14,9,35
1593,예산,4,7,18,6,35
2063,식중독,2,3,29,1,35
686,비서,10,11,13,1,35
585,휴대전화,11,10,9,5,35
856,유명,8,12,9,6,35
740,폭언,9,12,9,5,35
731,대비,9,5,16,5,35
690,지방,10,8,11,6,35
293,청장,19,5,8,3,35
694,호선,10,5,5,15,35
532,부담,12,9,8,6,35
881,종로,8,9,1,17,35
708,단계,9,9,13,4,35
2323,불개미,1,13,15,6,35
571,특혜,12,9,10,4,35
713,마음,9,13,10,3,35
380,전달,16,4,10,5,35
660,계획,10,8,14,3,35
1090,남북,6,18,6,4,34
1153,경남,6,4,18,6,34
755,민주,9,11,10,4,34
592,업자,11,5,15,3,34
818,잘못,8,10,5,11,34
843,감독,8,8,9,9,34
1074,불안,6,8,16,4,34
662,최초,10,13,9,2,34
462,추모,13,10,5,6,34
723,이제,9,9,6,10,34
382,축소,16,6,8,4,34
370,인천공항,16,7,7,4,34
1164,누가,6,12,9,7,34
1085,포기,6,9,12,7,34
883,합동,8,13,6,7,34
503,본사,13,15,4,2,34
1252,동의,5,9,12,8,34
1696,여론,3,12,4,15,34
1038,감사,6,5,11,11,33
1377,무기징역,4,16,12,1,33
613,통해,11,9,9,4,33
467,남녀,13,11,4,5,33
1068,연루,6,7,13,7,33
1507,가정,4,15,10,4,33
641,수사권,10,15,6,2,33
1283,지급,5,13,13,2,33
1454,실장,4,5,21,3,33
822,환경,8,11,7,7,33
567,제도,12,10,5,6,33
1103,수술,6,7,13,7,33
523,여전,12,8,8,5,33
1152,교육청,6,6,12,9,33
1098,형사,6,10,13,4,33
334,관여,17,4,10,2,33
1093,투표,6,20,3,4,33
790,예상,8,8,13,4,33
339,배우,17,5,10,1,33
785,업주,9,9,11,4,33
476,중앙,13,3,10,7,33
1832,일베,3,4,25,1,33
619,손님,11,10,6,6,33
1012,하라,7,11,12,3,33
732,처음,9,7,9,7,32
1425,성적,4,9,11,8,32
971,실명,7,5,8,12,32
1795,남용,3,11,11,7,32
780,재난,9,3,16,4,32
786,먼저,9,7,8,8,32
787,복지,9,15,6,2,32
825,전문가,8,5,10,9,32
831,과정,8,7,11,6,32
730,역사,9,10,3,10,32
682,민주당,10,13,5,4,32
695,공포,10,6,11,5,32
725,수용,9,9,11,3,32
666,돌입,10,8,11,3,32
581,현실,11,6,11,4,32
599,보장,11,4,14,3,32
578,식당,11,5,9,7,32
687,패소,10,12,6,4,32
2126,입국,2,9,14,7,32
427,마무리,14,6,10,2,32
390,관계자,15,9,6,2,32
783,무혐의,9,6,10,6,31
1337,거짓,5,12,12,2,31
274,권력,19,4,6,2,31
728,대형,9,5,11,6,31
458,용인,14,8,6,3,31
481,데이트,13,10,5,3,31
1078,반응,6,8,8,9,31
770,개인,9,8,6,8,31
479,협력,13,4,11,3,31
1296,광화문,5,8,12,6,31
1835,평가,3,16,6,6,31
669,충격,10,11,8,2,31
830,가해,8,6,7,10,31
634,예방,10,7,12,2,31
839,선원,8,4,12,7,31
1456,중국인,4,13,11,3,31
895,목숨,7,8,11,5,31
894,게임,7,9,11,4,31
850,작년,8,4,11,8,31
576,부검,12,5,8,6,31
869,분석,8,7,7,9,31
1406,경고,4,14,10,3,31
597,외압,11,10,4,6,31
756,산업,9,11,6,5,31
1073,자전거,6,7,10,8,31
297,이영학,19,2,7,3,31
417,면접,14,5,6,6,31
749,투약,9,10,5,6,30
1063,김기춘,6,2,18,4,30
840,원룸,8,10,8,4,30
423,시절,14,8,6,2,30
507,정체,13,3,9,5,30
422,강제추행,14,4,10,2,30
524,미국,12,12,5,1,30
1091,주말,6,9,14,1,30
912,신체,7,5,7,11,30
555,전화,12,9,5,4,30
668,아동학대,10,4,11,5,30
1487,음성,4,10,12,4,30
643,동물,10,6,9,5,30
504,협조,13,6,8,3,30
629,부족,11,6,9,4,30
626,선언,11,8,8,3,30
1368,응급실,5,5,14,6,30
1076,주식,6,10,9,5,30
515,발령,12,8,9,1,30
816,소득,8,5,10,7,30
1017,화물차,6,8,11,5,30
601,대화,11,10,4,5,30
611,파면,11,12,3,4,30
967,변경,7,9,12,2,30
615,이혼,11,9,5,5,30
371,안태,16,11,2,1,30
1684,전두환,3,14,11,2,30
1101,실시,6,5,14,5,30
1287,침입,5,13,10,2,30
798,임원,8,11,7,4,30
826,생활,8,11,6,4,29
919,영업,7,4,11,7,29
342,대학가,17,6,4,2,29
1312,개발,5,8,10,6,29
834,제공,8,9,9,3,29
1591,회원,4,12,7,6,29
901,속출,7,3,14,5,29
707,첫날,9,6,12,2,29
568,여경,12,4,8,5,29
1141,전과,6,9,11,3,29
623,철회,11,12,4,2,29
617,공공기관,11,4,11,3,29
1751,노후,3,11,4,11,29
878,출근,8,6,11,4,29
743,비난,9,7,7,6,29
1256,무면허,5,10,12,2,29
1932,인력,2,14,9,4,29
226,친부,23,2,2,2,29
449,선임,14,7,7,1,29
429,사위,14,3,4,8,29
409,학년,15,4,7,3,29
794,주변,8,10,6,5,29
965,심각,7,11,7,4,29
667,농성,10,11,6,2,29
1246,감정,5,8,5,11,29
991,만원,7,6,10,6,29
1420,동원,4,14,7,4,29
1329,핵심,5,9,9,6,29
1511,귀국,4,13,6,6,29
1418,지자체,4,4,12,8,28
452,수수,14,4,7,3,28
771,경험,9,11,6,2,28
1040,가스,6,16,1,5,28
625,무슨,11,8,5,4,28
897,영향,7,9,7,5,28
1039,퇴직,6,9,9,4,28
1030,고객,6,9,7,6,28
1463,기술,4,9,7,8,28
299,예술,18,2,4,4,28
387,위원장,15,2,6,5,28
612,교장,11,7,6,4,28
774,가구,9,8,10,1,28
814,강원,8,4,12,4,28
1752,보좌,3,15,9,1,28
684,증인,10,6,7,5,28
633,선물,10,9,8,1,28
698,상고,10,10,7,1,28
1083,소리,6,11,10,1,28
923,로스쿨,7,16,3,2,28
652,유지,10,9,5,4,28
514,치매,12,5,7,4,28
1747,개정,3,8,14,3,28
541,검증,12,5,3,8,28
1264,밀수,5,9,10,4,28
733,돼지,9,3,12,4,28
1227,고통,5,2,14,7,28
1159,자격,6,11,6,5,28
490,군산,13,4,8,3,28
560,지지,12,7,7,2,28
348,강릉,17,3,6,2,28
489,본부,13,6,7,2,28
487,여직원,13,8,4,3,28
837,통제,8,5,9,6,28
579,사연,11,9,3,5,28
445,대학교,14,1,8,4,27
529,방문,12,5,6,4,27
454,유기,14,6,4,3,27
572,조카,12,9,4,2,27
1731,돌진,3,10,9,5,27
562,소동,12,3,10,2,27
403,치사,15,1,6,5,27
543,적극,12,9,3,3,27
914,일본,7,8,9,3,27
1120,대가,6,7,5,9,27
975,산재,7,8,9,3,27
1023,고양이,6,8,11,2,27
705,영화,9,7,5,6,27
773,이름,9,3,6,9,27
738,필로폰,9,10,4,4,27
642,자매,10,4,7,6,27
789,기부,8,10,5,4,27
693,사인,10,3,11,3,27
674,상가,10,5,9,3,27
1371,온라인,4,11,8,4,27
622,폭탄,11,7,8,1,27
2432,노량진,1,4,6,16,27
1327,반려동물,5,1,15,6,27
1218,엄벌,5,6,5,11,27
1750,방안,3,7,7,10,27
942,통과,7,8,8,3,26
1431,오토바이,4,5,15,2,26
800,중상,8,12,5,1,26
653,보험금,10,2,10,4,26
715,건보,9,6,6,5,26
806,구속기소,8,6,7,5,26
920,집행,7,8,5,6,26
1504,노출,4,15,5,2,26
548,재단,12,7,5,2,26
658,바로,10,9,6,1,26
925,마트,7,8,8,3,26
926,신동빈,7,10,7,2,26
928,새마을금고,7,3,14,2,26
1319,해명,5,6,7,8,26
1114,롯데,6,8,9,3,26
1280,발부,5,10,5,6,26
1029,불만,6,12,7,1,26
1230,항의,5,8,11,2,26
1306,급식,5,4,13,4,26
1228,경비,5,9,10,2,26
781,정치자금,9,3,12,2,26
596,기억,11,5,5,5,26
876,노래방,8,6,8,4,26
676,내사,10,8,5,3,26
1988,허가,2,10,7,7,26
847,인터넷,8,5,8,5,26
628,인재,11,6,7,2,26
976,생명,7,6,11,2,26
1137,수준,6,10,5,5,26
1238,강력,5,8,7,5,25
703,정말,9,5,8,3,25
812,상황,8,9,5,3,25
1773,허용,3,4,9,9,25
792,강사,8,7,8,2,25
520,반성,12,3,4,6,25
772,시인,9,7,8,1,25
968,서도,7,7,10,1,25
408,입학,15,3,4,3,25
779,여교사,9,5,3,8,25
982,질환,7,5,10,3,25
1079,수익,6,7,6,6,25
960,걱정,7,5,10,3,25
764,최종,9,5,10,1,25
689,유가족,10,5,6,4,25
799,케어,8,8,6,3,25
805,여자친구,8,8,3,6,25
1245,동네,5,9,7,4,25
651,문무,10,13,1,1,25
1006,성공,7,5,5,8,25
1307,소장,5,9,9,2,25
836,지난해,8,3,7,7,25
563,측근,12,2,9,2,25
1035,법률,6,8,8,3,25
1031,무시,6,9,7,3,25
1291,선정,5,10,8,2,25
1457,나라,4,9,8,4,25
1281,목소리,5,5,8,7,25
1181,뇌물수수,6,9,5,5,25
917,선발,7,9,7,2,25
1367,교회,5,5,7,8,25
819,명품,8,5,3,9,25
2012,모델,2,16,5,2,25
393,마스크,15,6,1,3,25
1369,일반,5,10,4,6,25
1113,불허,6,5,9,5,25
2118,정전,2,1,21,1,25
849,꼼수,8,3,12,2,25
1032,훈련,6,9,5,4,24
721,명령,9,7,7,1,24
1540,인증,4,9,9,2,24
2112,유해,2,8,9,5,24
1007,애인,7,8,7,2,24
747,선수,9,5,8,2,24
1797,공정위,3,6,14,1,24
1289,비율,5,9,5,5,24
1552,위조,4,5,7,8,24
1623,전망,3,7,12,2,24
1215,반박,5,6,8,5,24
1346,시비,5,3,11,5,24
1820,중학생,3,8,10,3,24
1241,평화,5,11,7,1,24
767,차단,9,5,8,2,24
745,노무현,9,8,5,2,24
1576,체류,4,3,12,5,24
314,이중근,18,1,2,3,24
1468,음식,4,9,8,3,24
530,중고,12,5,3,4,24
813,모욕,8,8,4,4,24
1485,연금,4,6,9,5,24
892,수입,7,5,7,5,24
851,김해,8,1,12,3,24
644,별세,10,5,7,2,24
911,수업,7,10,5,2,24
823,최악,8,3,10,3,24
540,가방,12,1,5,6,24
679,권고,10,9,3,2,24
1147,배달,6,10,7,1,24
924,복귀,7,7,9,1,24
1706,알몸,3,3,3,15,24
533,파기,12,4,6,2,24
531,이동,12,3,7,2,24
1108,뿌리,6,8,8,2,24
569,육아,12,8,3,1,24
866,촛불,8,6,3,7,24
2047,기무사,2,2,15,5,24
1106,지방선거,6,12,4,2,24
1685,규탄,3,8,2,11,24
590,미끼,11,6,5,2,24
656,기획,10,6,3,5,24
874,불복,8,8,6,2,24
1856,드론,2,12,5,5,24
605,정규직,11,6,3,4,24
1087,종교,6,1,6,11,24
1253,안해,5,9,8,2,24
1278,회수,5,5,9,5,24
1140,대부분,6,7,2,8,23
2142,연구,2,6,9,6,23
1146,구역,6,6,6,5,23
1275,복구,5,6,7,5,23
1201,억대,5,10,6,2,23
1440,행인,4,6,7,6,23
1136,혼자,6,7,4,6,23
1133,진보,6,9,3,5,23
1443,해소,4,7,7,5,23
1041,공식,6,5,9,3,23
1584,보석,4,11,4,4,23
1060,노총,6,9,4,4,23
1062,절차,6,6,7,4,23
2241,아시아나,1,2,19,1,23
1190,소년원,5,4,6,8,23
1208,금융,5,9,5,4,23
1295,파악,5,5,11,2,23
1196,고양,5,3,2,13,23
1160,알선,6,3,11,3,23
817,비용,8,4,7,4,23
949,상사,7,9,6,1,23
639,월급,10,4,8,1,23
1792,방법,3,8,8,4,23
970,도움,7,9,5,2,23
750,진료,9,3,6,5,23
1707,스마트폰,3,7,6,7,23
741,둔기,9,8,5,1,23
1909,한강,2,6,12,3,23
937,부하,7,3,11,2,23
1728,언제,3,11,6,3,23
646,감시,10,5,4,4,23
985,자체,7,8,4,4,23
981,종합,7,2,6,8,23
664,정상,10,9,1,3,23
980,사흘,7,4,8,4,23
685,형량,10,3,6,4,23
591,침묵,11,4,6,2,23
673,은행,10,4,5,4,23
872,중요,8,5,5,5,23
1784,민원,3,5,13,2,23
1615,추돌,3,13,5,2,23
889,탈세,8,6,6,3,23
1019,감소,6,7,9,1,23
795,막말,8,8,5,2,23
527,인구,12,3,5,3,23
551,자신,12,4,6,1,23
1086,주목,6,4,9,3,22
1095,은폐,6,4,7,5,22
955,수습,7,5,3,7,22
2235,여름,1,7,13,1,22
900,교체,7,6,5,4,22
1475,근절,4,7,6,5,22
2041,음란물,2,6,3,11,22
1757,언론,3,11,5,3,22
692,전기,10,2,8,2,22
683,군인,10,3,7,2,22
1080,체납,6,6,3,7,22
1251,종료,5,7,7,3,22
1737,신도,3,8,6,5,22
1736,공천,3,7,11,1,22
1351,몸살,5,4,10,3,22
1787,반복,3,7,8,4,22
1107,면허,6,4,6,6,22
724,장치,9,2,5,6,22
1191,무사,5,8,6,3,22
1691,회삿돈,3,3,8,8,22
1142,식품,6,3,8,5,22
1124,도시,6,5,6,5,22
2337,경제,1,3,10,8,22
1403,대출,4,6,7,5,22
1493,거짓말,4,8,6,4,22
793,근로,8,8,1,5,22
1198,배임,5,8,8,1,22
918,포함,7,8,5,2,22
858,뺑소니,8,3,4,7,22
632,요양,11,3,3,5,22
600,수도권,11,5,3,3,22
1300,조성,5,7,8,2,22
1005,지속,7,4,9,2,22
1298,차장,5,6,8,3,22
494,암매장,13,2,6,1,22
577,크레인,12,6,3,1,22
997,충남,7,3,6,6,22
1315,삭제,5,8,6,3,22
1853,주년,2,9,7,4,22
1269,무산,5,8,3,6,22
1594,구멍,4,9,4,5,22
1009,법관,7,3,5,7,22
1025,반려견,6,6,7,3,22
1065,장자연,6,10,2,4,22
1050,명의,6,5,5,6,22
1334,고장,5,8,4,5,22
2069,통일,2,7,12,1,22
1654,앞바다,3,7,10,2,22
993,사무실,7,7,4,4,22
1254,손해배상,5,6,9,2,22
906,사례,7,8,2,4,21
1003,협회,7,7,5,2,21
1499,의뢰,4,6,5,6,21
1724,출국,3,12,3,3,21
972,등록,7,4,4,6,21
890,순직,7,5,8,1,21
1143,출근길,6,2,6,7,21
1657,해당,3,7,7,4,21
1288,불가피,5,2,10,4,21
1605,가격,3,7,9,2,21
886,중형,8,5,6,2,21
1189,차로,5,8,4,4,21
1182,진입,6,3,5,7,21
1742,시급,3,6,4,8,21
1452,지정,4,8,5,4,21
1765,결함,3,2,14,2,21
871,의회,8,3,8,2,21
848,대기,8,3,9,1,21
862,이송,8,4,7,2,21
375,부영,16,1,2,2,21
915,불명,7,3,10,1,21
2340,외국,1,7,11,2,21
1293,직업,5,6,5,5,21
1259,가슴,5,9,6,1,21
1514,열차,4,5,10,2,21
948,장기,7,9,2,3,21
654,타고,10,4,3,4,21
757,헌법,9,6,5,1,21
1822,사무장,3,11,2,5,21
950,지지자,7,8,5,1,21
1505,옥상,4,6,6,5,21
1632,프로그램,3,4,8,6,21
1349,카톡,5,8,4,4,21
935,접수,7,9,2,3,21
1054,전체,6,2,11,2,21
2053,원정,2,1,6,12,21
696,원세훈,10,7,3,1,21
1248,선생님,5,8,5,3,21
963,스님,7,4,8,2,21
1631,발암,3,8,9,1,21
1655,독도,3,5,7,6,21
1385,하늘,4,7,2,8,21
1643,정신,3,5,7,6,21
824,무효,8,6,4,2,20
443,출마,14,3,1,2,20
1330,태극기,5,5,6,4,20
835,취한,8,4,5,3,20
1347,차질,5,2,9,4,20
1432,중인,4,7,5,4,20
1761,노력,3,9,4,4,20
1395,우선,4,6,6,4,20
700,타이어,9,5,4,2,20
1204,회복,5,6,3,6,20
751,수원,9,2,8,1,20
1846,최근,2,3,6,9,20
1807,가입,3,3,9,5,20
1852,구매,2,4,7,7,20
744,분양,9,1,7,3,20
1877,강서,2,1,5,12,20
769,외부,9,3,4,4,20
1260,이전,5,2,10,3,20
1794,납품,3,6,7,4,20
1276,규정,5,3,10,2,20
587,고성,11,6,1,2,20
1229,당시,5,8,4,3,20
722,조윤선,9,1,9,1,20
1424,연인,4,7,7,2,20
702,공부,9,6,4,1,20
1021,여행,6,5,7,2,20
1686,공동,3,6,6,5,20
1069,최저,6,5,7,2,20
1127,불가,6,3,7,4,20
916,당한,7,5,4,4,20
1118,구한,6,6,4,4,20
1711,실패,3,6,9,2,20
1110,권리,6,4,6,4,20
1502,환경부,4,10,3,3,20
939,휴대폰,7,5,3,5,20
2256,포르노,1,3,1,15,20
2060,선처,2,9,7,2,20
2230,내용,1,5,11,3,20
974,천안,7,5,4,4,20
1553,상자,4,4,10,2,20
2495,도피,1,10,4,5,20
1055,고속,6,2,10,2,20
1565,시내버스,4,10,3,3,20
1571,고려,4,5,7,4,20
996,보조금,7,6,2,5,20
1628,감금,3,4,9,4,20
1624,재심,3,6,6,5,20
1034,요금,6,3,7,4,20
1620,복직,3,3,12,2,20
1011,꿀꺽,7,6,4,3,20
1618,기념,3,7,7,3,20
1015,도착,6,5,5,4,20
1129,자기,6,6,7,1,20
875,신입생,8,5,4,3,20
1735,비공개,3,8,7,2,20
1144,불편,6,4,7,3,20
1470,질문,4,7,6,3,20
1739,국회의원,3,8,5,4,20
884,작성,8,6,4,2,20
1165,책임자,6,2,8,4,20
1082,조선,6,10,2,1,19
959,저출산,7,4,5,3,19
688,포착,10,4,4,1,19
697,스프링클러,10,2,4,3,19
718,상대로,9,6,3,1,19
1583,분향소,4,8,6,1,19
1526,방침,4,7,5,3,19
953,배제,7,5,5,2,19
1436,주기,4,11,3,1,19
1678,전주,3,4,9,3,19
842,비밀,8,5,4,2,19
1234,행세,5,3,10,1,19
1000,사전,7,4,4,4,19
1247,재개,5,5,7,2,19
969,임신,7,4,5,3,19
675,김정은,10,6,2,1,19
1310,불륜,5,6,5,3,19
877,구성,8,3,6,2,19
670,지적,10,4,2,3,19
827,농장,8,2,3,6,19
1067,소방차,6,6,6,1,19
1047,오피스텔,6,7,4,2,19
1546,비위,4,1,7,7,19
1020,대리,6,3,4,6,19
987,총력,7,4,6,2,19
1328,진단,5,5,5,4,19
647,전교조,10,2,4,3,19
1633,가담,3,4,8,4,19
829,서류,8,5,5,1,19
2491,대진,1,14,3,1,19
2036,재범,2,7,4,6,19
1053,선장,6,6,6,1,19
941,군수,7,6,4,2,19
575,대중교통,12,2,4,1,19
1610,범인,3,8,6,2,19
896,부동산,7,3,6,3,19
905,계좌,7,3,8,1,19
1027,체결,6,4,6,3,19
1490,필리핀,4,12,1,2,19
775,전복,9,1,8,1,19
2336,청주,1,9,7,2,19
855,사체,8,6,3,2,19
1125,행안부,6,7,5,1,19
1783,생중계,3,9,3,4,19
2473,가사,1,15,2,1,19
1762,운전기사,3,5,5,6,19
1033,사이,6,5,4,4,19
810,시스템,8,2,2,7,19
1158,동시,6,5,6,2,19
2514,조명,1,8,7,3,19
1374,이별,4,8,3,4,19
1388,장서,4,3,7,5,19
752,고민,9,1,8,1,19
1117,가축,6,1,11,1,19
1462,홍보,4,5,7,3,19
1383,자치,4,6,4,5,19
844,제외,8,4,6,1,19
1430,파업,4,3,8,4,19
1112,능력,6,7,4,2,19
1777,인생,3,3,4,9,19
2418,창문,1,3,13,1,18
1467,행패,4,7,5,2,18
2414,의약품,1,6,5,6,18
1448,중심,4,8,4,2,18
1466,접근,4,3,6,5,18
2102,의인,2,14,1,1,18
2164,출제,2,4,2,10,18
1421,연락,4,5,6,3,18
1966,운영자,2,8,4,4,18
2099,벌써,2,7,8,1,18
2077,치마,2,6,7,3,18
2273,권성동,1,8,8,1,18
1726,메모,3,5,8,2,18
2270,프로포폴,1,11,3,3,18
1497,최소,4,3,5,6,18
1399,의문,4,4,5,5,18
1501,경찰서,4,2,4,8,18
1394,상처,4,6,3,5,18
2347,행정권,1,6,8,3,18
1390,갑론,4,2,8,4,18
1809,농가,3,2,8,5,18
1815,외면,3,5,5,5,18
1362,상해,5,4,6,3,18
1825,체포영장,3,8,5,2,18
1508,한번,4,5,3,6,18
1481,남부,4,8,2,4,18
1530,사범,4,6,7,1,18
2390,일가,1,11,4,2,18
2227,플라스틱,1,7,8,2,18
2392,창업,1,3,9,5,18
1982,승차,2,5,3,8,18
929,사관,7,6,3,2,18
1861,자연,2,3,10,3,18
958,제보,7,6,4,1,18
1126,아래,6,3,7,2,18
1119,원금,6,4,1,7,18
922,골프,7,8,2,1,18
768,응원,9,2,3,4,18
1018,스트레스,6,3,6,3,18
2521,진짜,1,8,6,3,18
1096,상담,6,4,6,2,18
1088,들통,6,7,3,2,18
913,법적,7,2,6,3,18
717,보완,9,4,3,2,18
1051,보관,6,3,6,3,18
631,어금니,11,2,4,1,18
598,수요,11,3,3,1,18
865,다리,8,7,2,1,18
888,방서,8,3,5,2,18
782,내부,9,5,1,3,18
1285,창고,5,1,9,3,18
863,야간,8,2,5,3,18
1172,계약,6,4,5,3,18
803,비방,8,6,1,3,18
2484,용산,1,9,6,2,18
868,관광,8,4,4,2,18
1527,기름,4,6,5,2,17
1533,방지,4,6,6,1,17
1097,환송,6,4,5,2,17
1223,심의,5,3,5,4,17
944,임대주택,7,4,3,3,17
1077,양성,6,6,2,3,17
1509,무고,4,6,4,3,17
680,차관,10,5,1,1,17
1944,해제,2,2,11,2,17
763,정지,9,1,6,1,17
1379,의지,4,6,6,1,17
1212,금고,5,3,4,5,17
672,변명,10,2,4,1,17
1183,내달,5,5,4,3,17
1156,괴롭힘,6,4,4,3,17
760,청소,9,3,4,1,17
1207,다음,5,6,4,2,17
1683,유발,3,4,7,3,17
2025,심신,2,1,1,13,17
1447,목포,4,5,2,6,17
1925,부자,2,3,6,6,17
1701,벤츠,3,7,2,5,17
1753,체제,3,6,7,1,17
1169,며느리,6,6,4,1,17
2483,완전,1,3,7,6,17
2031,공급,2,5,8,2,17
736,춘천,9,2,2,4,17
845,개정안,8,5,3,1,17
1705,게시,3,2,8,4,17
1151,혁신,6,7,3,1,17
1471,제거,4,4,4,5,17
1149,전담,6,3,6,2,17
2279,정치권,1,4,8,4,17
1803,이메일,3,5,3,6,17
1482,교도소,4,5,7,1,17
1138,미흡,6,7,2,2,17
936,육아휴직,7,3,5,2,17
712,생존자,9,3,2,3,17
1203,유감,5,4,5,3,17
864,실수,8,6,1,2,17
909,종결,7,4,4,2,17
1551,수급,4,2,5,6,17
1072,행동,6,1,5,5,17
2149,경주,2,3,7,5,17
907,민간,7,2,6,2,17
1653,초과,3,3,7,4,17
1649,간다,3,7,6,1,17
1340,그대로,5,3,6,3,17
1308,홀로,5,7,3,2,17
1249,변화,5,5,6,1,17
1044,협의,6,4,5,2,17
2150,부대,2,6,4,5,17
635,여대생,10,3,1,3,17
2397,우울증,1,6,1,9,17
1590,감식,4,4,4,5,17
1042,박탈,6,3,7,1,17
1002,발목,7,4,5,1,17
1313,정권,5,8,3,1,17
1622,위증,3,10,2,2,17
616,평택,11,2,3,1,17
1010,화상,7,2,6,2,17
1981,경쟁,2,4,10,1,17
893,노모,7,5,3,2,17
1607,중독,3,4,8,2,17
1049,인기,6,4,6,1,17
1318,공익,5,5,5,2,17
984,소녀,7,3,4,3,17
1743,생산,3,7,5,2,17
1297,기온,5,2,8,2,17
580,참변,11,1,2,3,17
1242,세금,5,8,3,1,17
885,출범,8,4,4,1,17
1286,강간,5,4,4,4,17
986,특정,7,6,3,1,17
1355,의미,5,7,3,2,17
2048,사각,2,8,4,3,17
1239,실태,5,5,2,5,17
659,학과,10,3,2,2,17
1303,수석,5,2,2,8,17
788,불참,9,1,6,1,17
1139,고령,6,2,3,5,16
1444,시청,4,5,4,3,16
1446,연쇄,4,6,5,1,16
992,술집,7,6,1,2,16
1175,경상,6,3,4,3,16
998,배소,7,3,5,1,16
1170,과실,6,4,1,5,16
995,운항,7,2,5,2,16
838,한잔,8,3,4,1,16
1157,괴물,6,3,6,1,16
994,선배,7,5,3,1,16
2298,영아,1,1,9,5,16
1555,토론회,4,7,1,4,16
1614,트럭,3,3,8,2,16
2179,통화,1,5,5,5,16
1668,반입,3,7,2,4,16
854,빌딩,8,4,3,1,16
1788,지구대,3,7,2,4,16
1671,위원,3,5,5,3,16
1075,일대,6,3,5,2,16
1664,성분,3,5,4,4,16
2043,격리,2,3,8,3,16
1561,운명,4,3,7,2,16
2191,여대,1,1,4,10,16
1675,취객,3,7,4,2,16
2185,전자담배,1,9,1,5,16
1676,보건,3,4,5,4,16
1084,대처,6,2,4,4,16
2244,대학원생,1,10,4,1,16
2124,매년,2,2,5,7,16
1518,제안,4,2,6,4,16
880,체험,8,1,6,1,16
2169,종업원,2,5,7,2,16
1579,입시,4,5,3,4,16
2522,속옷,1,8,4,3,16
1778,봉사,3,3,5,5,16
1495,흡입,4,2,7,3,16
951,전역,7,3,5,1,16
1128,기범,6,5,2,3,16
1597,결식,3,5,4,4,16
1600,평양,3,7,4,2,16
1775,역주행,3,6,2,5,16
943,라인,7,6,1,2,16
1694,조롱,3,7,4,2,16
2173,판정,2,1,7,6,16
2076,주사,2,2,5,7,16
1363,민주주의,5,6,1,4,16
1703,소음,3,6,2,5,16
2022,매달,2,4,3,7,16
1843,결제,2,3,7,4,16
1202,변호,5,2,5,4,16
1413,초등학교,4,6,2,4,16
1412,민간인,4,5,5,2,16
1411,취하,4,2,4,6,16
1262,위헌,5,5,2,4,16
1372,공유,4,3,6,3,16
1376,학습,4,9,2,1,16
1900,신뢰,2,6,2,6,16
921,보안,7,3,4,2,16
2368,편파,1,5,9,1,16
1875,실질,2,3,5,6,16
1400,접대,4,9,1,2,16
1220,옥중,5,5,3,3,16
1209,과제,5,4,5,2,16
2015,압수,2,4,2,8,16
1850,주행,2,1,12,1,16
1734,동포,3,6,3,4,16
1314,약속,5,5,4,2,16
1301,납치,5,1,7,3,16
1426,기숙사,4,5,4,3,16
1236,제대로,5,2,5,4,16
1240,신설,5,2,5,4,16
739,아침,9,2,3,2,16
2026,미약,2,1,1,12,16
1342,찬성,5,2,3,6,16
2436,임대,1,3,6,6,16
1250,연령,5,4,5,2,16
1216,당선,5,4,4,2,15
1089,회식,6,5,2,2,15
776,묵인,9,1,2,3,15
1521,끝내,4,4,4,3,15
1290,탈북민,5,4,5,1,15
1568,현대차,4,2,5,4,15
1389,흔적,4,3,4,4,15
846,최경환,8,2,2,3,15
1904,조희연,2,6,3,4,15
2057,협약,2,4,6,3,15
1515,염동열,4,8,2,1,15
1779,현수막,3,7,3,2,15
1217,김부겸,5,4,5,1,15
1758,행각,3,4,5,3,15
1384,육군,4,4,5,2,15
2219,선거법,1,2,7,5,15
1052,폐업,6,2,5,2,15
1048,장학금,6,4,4,1,15
870,장례식,8,2,2,3,15
2388,불신,1,5,7,2,15
1442,선박,4,6,4,1,15
1541,가지,4,5,4,2,15
2437,시속,1,2,8,4,15
1102,위법,6,6,1,2,15
2202,질주,1,2,10,2,15
808,로비,8,1,5,1,15
1721,개방,3,5,5,2,15
1358,장사,5,6,3,1,15
947,만남,7,4,3,1,15
1357,나들이,5,3,5,2,15
902,신축,7,2,5,1,15
2004,현대,2,5,7,1,15
2154,총수,2,5,4,4,15
1100,전수,6,4,2,3,15
811,최선,8,3,3,1,15
1959,민변,2,7,5,1,15
1008,행복,7,3,3,2,15
1404,기계,4,3,7,1,15
2027,불안감,2,2,7,4,15
1638,노동계,3,9,2,1,15
2021,기본,2,4,3,6,15
1316,도전,5,4,5,1,15
1480,기능,4,5,5,1,15
2285,싸움,1,4,8,2,15
1014,발화,7,2,5,1,15
931,제명,7,4,2,2,15
2091,농도,2,10,2,1,15
727,터미널,9,2,3,1,15
1769,구직,3,3,7,2,15
1193,명예,5,3,5,2,15
990,개인정보,7,1,5,2,15
1013,국과수,7,2,4,2,15
1931,낚시,2,8,4,1,15
1934,유서,2,3,8,2,15
1496,오염,4,6,4,1,15
1022,짝퉁,6,2,4,3,15
2265,정의,1,3,3,8,15
1299,담당,5,4,2,4,15
2410,가정폭력,1,2,5,7,15
2000,권한,2,4,5,4,15
2080,지대,2,6,6,1,15
2017,정치인,2,8,4,1,15
1185,기대,5,3,4,3,15
2073,폭풍,2,2,6,5,15
977,동결,7,3,4,1,15
1872,차이,2,6,5,2,15
1449,지하,4,7,3,1,15
1450,비극,4,2,6,3,15
1869,자진,2,4,4,5,15
2083,공감,2,4,5,3,14
1580,속보,4,2,6,2,14
1046,브로커,6,3,4,1,14
1582,대입,4,3,2,5,14
1339,방조,5,5,2,2,14
1764,코치,3,5,5,1,14
1634,불과,3,3,6,2,14
887,투숙,8,1,3,2,14
1344,목표,5,3,2,4,14
2427,출입,1,7,2,4,14
1036,스스로,6,4,3,1,14
2135,혜택,2,1,10,1,14
2125,유인,2,7,3,2,14
1611,대한,3,7,2,2,14
1656,회담,3,9,1,1,14
1873,변협,2,9,2,1,14
2139,시술,2,6,5,1,14
1265,불법체류,5,2,4,3,14
1596,오류,4,5,1,4,14
1037,나이,6,2,5,1,14
1336,얼마나,5,3,2,4,14
1317,혹시,5,3,3,3,14
1258,유력,5,2,3,4,14
1026,주요,6,4,2,2,14
1001,불량,7,3,3,1,14
1043,항공기,6,1,5,2,14
1651,전력,3,4,4,3,14
1335,자식,5,3,4,2,14
891,반납,7,1,4,2,14
2431,윤리,1,5,3,5,14
930,의도,7,2,3,2,14
1345,명중,5,5,3,1,14
1392,도도,4,2,3,5,14
2464,증세,1,4,6,3,14
1570,압박,4,4,4,2,14
2503,질병,1,7,5,1,14
1498,정비,4,3,3,4,14
711,형제,9,1,3,1,14
1941,대낮,2,3,4,5,14
1130,축사,6,3,4,1,14
1488,공약,4,6,3,1,14
1908,월드,2,4,5,3,14
1821,법원행정처,3,3,6,2,14
932,북적,7,3,3,1,14
1474,근거,4,4,3,3,14
1473,현재,4,3,4,3,14
1756,세대,3,7,3,1,14
1688,역할,3,4,6,1,14
1161,점거,6,3,4,1,14
1162,변론,6,1,1,6,14
2290,당첨,1,1,7,5,14
1423,포천,4,2,5,3,14
1167,친모,6,5,2,1,14
1690,고향,3,5,5,1,14
1458,대사,4,4,4,2,14
1434,직권남용,4,3,2,5,14
2310,비행기,1,6,6,1,14
1176,적폐,6,3,2,3,14
1177,묵묵,6,2,5,1,14
758,답변,9,3,1,1,14
1693,위력,3,1,8,2,14
759,한마디,9,2,2,1,14
1393,제작,4,2,3,5,14
2513,중학교,1,5,6,2,14
1826,퇴진,3,4,5,2,14
1370,냄새,4,3,5,2,14
1884,취준생,2,5,3,4,14
957,소재,7,1,5,1,14
2005,대금,2,4,5,3,14
2052,유차,2,4,1,7,14
1885,캠퍼스,2,4,7,1,14
1886,수상,2,3,4,5,14
1889,성과,2,3,8,1,14
1235,총력전,5,4,3,2,14
1059,익산,6,2,4,2,14
1364,박상기,5,3,2,4,14
1790,신상,3,2,5,4,14
1542,출생,4,5,3,2,14
1539,피고인,4,7,2,1,14
1506,부과,4,2,5,3,14
2006,전격,2,2,4,6,14
1532,경력,4,4,2,4,14
2264,탄핵,1,3,5,5,14
867,일정,8,1,4,1,14
1531,로또,4,5,4,1,14
1760,강의,3,5,3,3,14
1373,남학생,4,3,6,1,14
1522,유도,4,3,4,3,14
946,통영,7,2,3,1,13
1700,국선,3,6,2,2,13
1999,고백,2,6,4,1,13
962,특보,7,1,4,1,13
1665,표시,3,1,1,8,13
1677,임산부,3,2,4,4,13
1738,주력,3,4,5,1,13
1719,메시지,3,4,4,2,13
978,거절,7,1,2,3,13
859,폭발물,8,3,1,1,13
1670,더니,3,3,5,2,13
1659,측정,3,4,2,4,13
1650,이주,3,3,4,3,13
1708,솜방망이,3,3,1,6,13
927,재수,7,2,1,3,13
2253,쟁점,1,1,10,1,13
1644,기승,3,2,7,1,13
1145,난항,6,3,3,1,13
1402,설립,4,1,3,5,13
1405,직전,4,2,6,1,13
1408,날씨,4,1,3,5,13
1410,총리,4,2,4,3,13
1415,봇물,4,4,2,3,13
1818,성남,3,3,4,3,13
1912,여배우,2,2,6,3,13
1422,공격,4,3,4,2,13
1427,고심,4,1,3,5,13
1917,사무소,2,3,5,3,13
1921,손실,2,3,5,3,13
1184,노사,5,4,3,1,13
1438,도서관,4,4,4,1,13
1451,화제,4,5,1,3,13
1455,봉투,4,3,2,4,13
2494,내주,1,7,2,3,13
2287,출장,1,6,4,2,13
1206,일단,5,2,5,1,13
2346,구급차,1,7,4,1,13
1381,글쎄,4,6,2,1,13
1849,검경,2,7,2,2,13
1866,지목,2,4,2,5,13
1279,부산시,5,5,1,2,13
1274,검찰총장,5,4,3,1,13
1271,시효,5,1,3,4,13
1268,인식,5,3,3,2,13
2412,상승,1,4,5,3,13
1321,정리,5,3,3,2,13
2399,임명,1,4,6,2,13
1830,소통,3,2,4,4,13
1261,취재,5,5,2,1,13
1243,분야,5,3,2,3,13
1237,생존,5,3,3,2,13
1359,전날,5,3,3,2,13
1360,연합,5,1,2,5,13
1892,고립,2,1,5,5,13
1225,당부,5,3,4,1,13
1930,지난,2,1,5,5,13
2311,전무,1,9,2,1,13
2272,여의도,1,3,7,2,13
1544,의대,4,4,4,1,13
1953,말다툼,2,4,4,3,13
1056,부분,6,1,4,2,13
1557,여수,4,1,5,3,13
1486,면담,4,5,3,1,13
1558,지구,4,1,4,4,13
1559,국장,4,2,6,1,13
1958,소유,2,4,3,4,13
2187,입법,1,4,6,2,13
2184,얘기,1,6,4,2,13
1599,하나요,3,4,4,2,13
1961,무상,2,2,8,1,13
2122,창원,2,1,7,3,13
1613,가중,3,5,3,2,13
1619,이벤트,3,4,5,1,13
1625,탐색,3,5,4,1,13
1630,김포,3,1,2,7,13
2082,직무,2,7,3,1,13
784,영진,9,2,1,1,13
1741,수사의뢰,3,6,1,3,13
1535,한밤중,4,2,5,2,13
1131,재해,6,4,1,2,13
1081,불감증,6,3,3,1,13
1529,연봉,4,1,7,1,13
2228,정신질환,1,7,1,4,13
1525,게시판,4,1,3,5,13
1519,신호,4,5,2,2,13
1513,퇴사,4,2,2,5,13
1510,호기,4,5,3,1,13
1791,교류,3,4,3,2,12
1772,정도,3,3,1,5,12
1744,친형,3,2,4,3,12
1806,소주,3,3,2,4,12
1971,상반기,2,3,6,1,12
815,이불,8,1,2,1,12
1940,해양,2,5,4,1,12
1746,주도,3,4,3,2,12
1927,심판,2,4,3,3,12
1855,개설,2,2,5,3,12
1766,배경,3,2,4,3,12
1960,노예,2,5,3,2,12
1983,제정,2,1,5,4,12
1926,누군가,2,3,3,4,12
1842,쇼핑,2,2,7,1,12
857,고생,8,1,2,1,12
807,기회,8,1,2,1,12
1897,요건,2,2,6,2,12
1991,하락,2,4,4,2,12
1810,채팅,3,3,5,1,12
1898,완화,2,3,6,1,12
1901,수첩,2,7,2,1,12
1816,논문,3,3,4,2,12
1785,용기,3,5,3,1,12
1903,동기,2,3,5,2,12
1292,마비,5,2,1,4,12
1740,여권,3,2,3,4,12
2369,한전,1,5,2,4,12
1407,소명,4,3,3,2,12
1409,분당,4,2,3,3,12
1417,기상청,4,5,1,2,12
1200,실효,5,2,1,4,12
1199,수배,5,2,4,1,12
1197,국정원장,5,4,2,1,12
1428,수감,4,1,2,5,12
1188,남양주,5,3,3,1,12
1186,해도,5,1,4,2,12
1433,연관,4,1,2,5,12
2320,익사,1,2,5,4,12
2485,성인,1,6,2,3,12
1445,스마트,4,1,2,5,12
2291,보료,1,6,2,3,12
1472,신규,4,2,5,1,12
1479,통행,4,4,2,2,12
898,저수지,7,1,3,1,12
1491,요원,4,2,3,3,12
2268,결의,1,3,5,3,12
1105,무방비,6,3,2,1,12
2517,펑펑,1,3,5,3,12
2474,업계,1,3,3,5,12
2373,양주,1,9,1,1,12
2229,인간,1,7,3,1,12
2376,실체,1,5,2,4,12
2419,부품,1,1,7,3,12
1284,불응,5,3,2,2,12
1277,화장품,5,1,4,2,12
1266,통계,5,2,3,2,12
1320,즉각,5,1,5,1,12
1322,의장,5,2,3,2,12
1324,백화점,5,1,5,1,12
2405,중앙회,1,2,2,7,12
1263,공짜,5,4,1,2,12
1331,신원,5,3,3,1,12
1257,항공사,5,3,3,1,12
1255,순간,5,2,4,1,12
1343,고개,5,2,3,2,12
1348,거액,5,3,3,1,12
1350,제조,5,3,3,1,12
1352,작전,5,1,3,3,12
1353,편입,5,3,3,1,12
1356,투기,5,4,1,2,12
2384,논쟁,1,1,8,2,12
2443,그늘,1,2,7,2,12
1224,격차,5,3,2,2,12
1094,번호,6,3,1,2,12
1132,다툼,6,2,3,1,12
1858,기한,2,3,4,3,12
1587,안정,4,2,5,1,12
2075,코리아,2,4,4,2,12
2527,반영,1,5,4,2,12
1699,장난,3,3,3,3,12
2137,할아버지,2,1,5,4,12
2136,행진,2,2,4,4,12
2134,손배,2,6,3,1,12
1016,로부터,6,3,2,1,12
1695,동덕여대,3,1,2,6,12
2106,도마,2,5,2,3,12
1537,부근,4,5,1,2,12
1679,대선,3,5,3,1,12
945,상납,7,2,2,1,12
973,서울역,7,1,3,1,12
2537,장비,1,5,5,1,12
979,주거,7,1,3,1,12
1589,전용,4,2,5,1,12
2023,대규모,2,5,3,2,12
1710,안내,3,2,5,2,12
1057,민낯,6,1,4,1,12
1066,설명,6,2,3,1,12
2002,목격,2,6,3,1,12
1064,강행,6,2,1,3,12
1723,편지,3,5,3,1,12
1713,분통,3,3,2,4,12
983,위로,7,1,3,1,12
1562,상실,4,2,5,1,12
2188,고작,1,4,4,3,12
2176,유령,2,4,4,2,12
2008,서로,2,2,5,2,11
1878,필수,2,1,2,6,11
2033,반려,2,3,1,5,11
2009,장면,2,3,4,2,11
2035,회계,2,3,3,3,11
2037,북상,2,1,6,2,11
2014,등교,2,2,6,1,11
2424,가을,1,1,4,5,11
2046,동창,2,4,4,1,11
2003,정유,2,6,2,1,11
2413,경로,1,2,5,3,11
1945,무관,2,4,3,2,11
2449,대안,1,5,2,3,11
2079,조형,2,5,2,2,11
1949,서경덕,2,2,6,1,11
2515,금은,1,4,2,4,11
2224,낙태죄,1,6,2,2,11
2271,실습,1,4,4,2,11
2212,생리대,1,3,2,5,11
2499,촛불집회,1,5,2,3,11
2197,배출,1,6,2,2,11
2194,유전자,1,2,6,2,11
2321,낙태,1,2,7,1,11
2174,수시,2,2,3,4,11
2327,착취,1,5,3,2,11
2482,불꽃,1,3,4,3,11
2330,유튜브,1,1,4,5,11
1965,자제,2,2,6,1,11
2120,지법,2,5,3,1,11
1905,동물권,2,3,5,1,11
2345,야근,1,5,3,2,11
2454,아프리카,1,2,7,1,11
2367,한숨,1,3,4,3,11
2453,전형,1,5,3,2,11
2105,캠페인,2,4,3,2,11
2463,일회용,1,1,5,4,11
1273,지옥,5,3,2,1,11
1574,유리,4,2,4,1,11
1484,기내,4,3,2,2,11
1646,농민,3,2,4,2,11
1799,역학,3,3,4,1,11
1233,한밤,5,4,1,1,11
1231,통합,5,1,3,2,11
1476,임박,4,4,2,1,11
1800,대원,3,4,3,1,11
1640,임시,3,5,1,2,11
1477,민중,4,2,3,2,11
1804,열기,3,3,2,3,11
1805,공직,3,4,1,3,11
1796,행방,3,2,5,1,11
1375,발굴,4,2,2,3,11
1211,사무,5,4,1,1,11
1210,보강,5,2,2,2,11
1626,만료,3,1,4,3,11
1523,은혜,4,1,2,4,11
1524,번복,4,1,4,2,11
1192,조기,5,3,2,1,11
1817,약자,3,4,2,2,11
1187,커플,5,3,2,1,11
1648,심폐소생술,3,5,2,1,11
1267,여사,5,2,2,2,11
1621,탑승,3,2,2,4,11
1768,열정,3,4,2,2,11
1365,사정,5,3,2,1,11
1729,휠체어,3,3,3,2,11
1387,탈락,4,3,3,1,11
1714,후원,3,4,1,3,11
1332,여파,5,3,2,1,11
1326,후회,5,1,3,2,11
1414,사안,4,2,2,3,11
1687,대폭,3,3,1,4,11
1416,백신,4,3,1,3,11
1419,청사,4,5,1,1,11
1270,공소,5,2,2,2,11
1325,교감,5,1,3,2,11
1323,야구,5,2,2,2,11
1439,여객선,4,2,2,3,11
1309,빈소,5,1,2,3,11
1669,태국인,3,2,5,1,11
1663,관행,3,3,2,3,11
1294,파출소,5,1,3,2,11
1786,빌라,3,4,1,3,11
1789,취약,3,3,3,2,11
1819,소문,3,4,2,2,11
1378,절대,4,1,1,5,11
1534,체육,4,3,2,2,11
1099,이사,6,1,2,2,11
1854,일선,2,1,4,4,11
1837,물건,3,4,3,1,11
1848,앙심,2,6,1,2,11
1045,승소,6,1,2,2,11
1116,맥주,6,3,1,1,11
1134,완도,6,2,2,1,11
1608,강아지,3,3,4,1,11
1135,외출,6,1,2,2,11
1569,후임,4,3,3,1,11
1572,가게,4,3,2,2,11
1601,꼬리,3,2,5,1,11
1543,상당,4,1,4,2,11
1578,처남,4,5,1,1,11
1104,가출,6,2,2,1,11
1617,임용,3,1,6,1,11
1560,보상금,4,1,4,2,11
1831,시정,3,6,1,1,11
1612,쇼핑몰,3,5,1,2,11
1586,구입,4,3,2,2,11
1178,참가,6,1,2,2,11
1616,애도,3,2,5,1,11
1680,먹튀,3,1,3,3,10
1429,착용,4,1,4,1,10
1585,복원,4,4,1,1,10
2038,응시,2,5,2,1,10
1673,용서,3,1,3,3,10
1437,구제,4,1,4,1,10
1564,불공정,4,3,2,1,10
2234,마당,1,1,3,5,10
1397,입찰,4,1,1,4,10
1566,오해,4,2,2,2,10
2018,양육,2,2,2,4,10
1382,누나,4,2,3,1,10
2168,개장,2,3,4,1,10
2362,조선족,1,2,5,2,10
2355,중계,1,5,2,2,10
2011,동안,2,3,3,2,10
2180,콘텐츠,1,3,4,2,10
1704,다음주,3,3,1,3,10
2159,수갑,2,6,1,1,10
1567,소지,4,2,2,2,10
1702,설계,3,3,3,1,10
2055,자사고,2,1,4,3,10
1398,미스터리,4,2,3,1,10
2160,갑질,2,5,2,1,10
2030,옥살이,2,4,2,2,10
2054,서해,2,2,3,3,10
1461,장소,4,3,1,2,10
1453,헌법소원,4,2,1,3,10
2226,봉쇄,1,1,6,2,10
2127,비자,2,2,4,2,10
1483,압류,4,3,1,2,10
2223,사생활,1,1,4,4,10
2085,특별법,2,1,5,2,10
2267,부작용,1,2,3,4,10
1503,단순,4,2,1,3,10
1512,그날,4,3,2,1,10
2201,추돌사고,1,3,1,5,10
2260,박람회,1,3,5,1,10
2098,폭주,2,1,5,2,10
2101,곤란,2,3,1,4,10
1520,지점,4,2,2,2,10
1536,대학원,4,1,3,2,10
2111,헌법재판관,2,1,6,1,10
2128,방위,2,3,3,2,10
1549,중간,4,1,4,1,10
2215,하천,1,4,4,1,10
2286,인도,1,1,7,1,10
1603,시아버지,3,2,4,1,10
1645,인원,3,5,1,1,10
1602,차원,3,2,4,1,10
1595,파리,4,2,3,1,10
2071,본인,2,4,1,3,10
2144,누락,2,4,3,1,10
1464,태운,4,4,1,1,10
1652,재정,3,4,1,2,10
2146,민노총,2,4,2,2,10
1859,공연,2,1,6,1,10
2303,구축,1,5,3,1,10
1660,존재,3,2,1,4,10
1459,감동,4,2,1,3,10
1494,사과문,4,3,2,1,10
2351,조국,1,1,1,7,10
1972,성범죄자,2,1,5,2,10
2488,행렬,1,1,5,3,10
1978,일주일,2,1,5,2,10
2504,신발,1,4,1,4,10
1123,황당,6,2,1,1,10
2400,체불,1,3,4,2,10
1891,신임,2,3,3,2,10
2404,격분,1,5,3,1,10
1893,대체,2,1,1,6,10
1973,매도,2,4,3,1,10
1968,디자인,2,2,3,3,10
1771,스토킹,3,2,1,4,10
1163,끼리,6,1,2,1,10
1824,야생,3,2,2,3,10
2508,치유,1,3,3,3,10
1179,참여연대,6,2,1,1,10
1305,기분,5,2,2,1,10
1302,오른,5,1,2,2,10
1812,고문,3,1,3,3,10
1213,친딸,5,2,2,1,10
1811,부천,3,4,2,1,10
1929,전액,2,1,6,1,10
1219,수정,5,1,2,2,10
1244,무마,5,3,1,1,10
1226,독립,5,1,3,1,10
1232,식구,5,1,3,1,10
1980,노숙인,2,3,3,2,10
2435,활성화,1,1,6,2,10
1863,되풀이,2,3,4,1,10
1984,기피,2,6,1,1,10
989,유학,7,1,1,1,10
1109,목줄,6,1,1,2,10
1338,집안,5,2,2,1,10
1028,실제,6,2,1,1,10
1989,셀프,2,3,1,4,10
1121,먹이,6,1,1,2,10
1763,우린,3,2,2,3,10
2472,충주,1,3,3,2,9
2540,외상,1,4,2,2,9
1635,청정,3,2,1,3,9
1813,출입국,3,3,1,2,9
2255,해법,1,2,4,2,9
1516,처방,4,1,2,2,9
2466,한국사,1,4,3,1,9
2511,불기소,1,3,1,4,9
1214,유입,5,1,2,1,9
2457,정시,1,3,2,3,9
1492,소란,4,1,3,1,9
1194,분리,5,2,1,1,9
2087,경위,2,3,2,2,9
2086,대치,2,2,3,2,9
2165,교복,2,1,5,1,9
2544,학교폭력,1,2,5,1,9
1862,동해안,2,1,4,2,9
1641,웹툰,3,4,1,1,9
2170,선거운동,2,3,2,2,9
2240,나체,1,3,3,2,9
1823,부순,3,3,2,1,9
1851,날벼락,2,1,5,1,9
2140,약물,2,3,1,3,9
2512,시공사,1,2,5,1,9
2143,포장,2,1,4,2,9
2216,진학,1,3,2,3,9
2145,친환경,2,1,3,3,9
2130,오픈,2,4,1,2,9
2220,여기,1,1,5,2,9
1879,현역,2,1,4,2,9
1798,배포,3,2,3,1,9
1894,미제,2,4,2,1,9
2519,먼지,1,4,3,1,9
1547,낙서,4,1,1,3,9
2151,물의,2,3,2,2,9
2520,방향,1,2,3,3,9
2489,그냥,1,4,1,3,9
1847,악몽,2,2,3,2,9
1828,복무,3,1,2,3,9
1827,수상한,3,1,1,4,9
2155,기증,2,1,3,3,9
2232,등산,1,1,2,5,9
2114,이해,2,3,3,1,9
2486,민주화,1,5,2,1,9
1993,보고서,2,4,2,1,9
2448,제압,1,2,5,1,9
2407,계단,1,2,2,4,9
1333,수두,5,1,2,1,9
2049,연구원,2,2,4,1,9
2317,태아,1,1,6,1,9
2319,언론사,1,2,5,1,9
1776,서귀포,3,2,2,2,9
1962,매장,2,1,5,1,9
2357,발송,1,4,1,3,9
1311,중태,5,2,1,1,9
1672,오락가락,3,1,3,2,9
1718,상향,3,2,3,1,9
2411,악용,1,3,2,3,9
2040,환수,2,3,3,1,9
2074,확장,2,2,4,1,9
1780,드라마,3,2,3,1,9
1970,코레일,2,2,4,1,9
2331,화학,1,6,1,1,9
1985,줄줄이,2,2,3,2,9
1767,완료,3,3,1,2,9
1716,골프장,3,3,2,1,9
1692,통행료,3,1,3,2,9
1977,졸음,2,2,4,1,9
2013,시선,2,3,2,2,9
2024,정착,2,3,2,2,9
1396,갈취,4,1,3,1,9
2396,공채,1,2,4,2,9
1722,세력,3,4,1,1,9
2051,보름,2,3,2,2,9
1386,학위,4,1,3,1,9
2061,만족도,2,3,3,1,9
2434,살기,1,4,3,1,9
2072,실업,2,2,4,1,9
1748,데이,3,3,2,1,9
1997,이중,2,4,2,1,9
2433,가맹,1,4,3,1,9
1946,스타,2,1,5,1,9
1272,치기,5,1,1,2,9
2292,조물,1,6,1,1,9
2066,손자,2,3,3,1,9
2065,금괴,2,4,2,1,9
2293,법안,1,2,3,3,9
1745,번진,3,3,2,1,9
1380,포획,4,3,1,1,9
1712,회피,3,2,1,3,9
1954,트라우마,2,3,2,2,9
1733,일방,3,1,2,3,9
1782,생후,3,1,4,1,9
1441,무릎,4,2,1,2,9
2059,감옥,2,2,4,1,9
1730,원칙,3,2,1,3,9
2359,홈페이지,1,2,2,3,8
1575,사다리,4,1,1,2,8
2391,공정,1,2,3,2,8
1366,미달,5,1,1,1,8
1563,기적,4,1,2,1,8
2204,북미,1,4,2,1,8
2542,활용,1,2,2,3,8
2186,교환,1,2,3,2,8
2538,확충,1,2,3,2,8
1556,인터뷰,4,1,1,2,8
2178,열람,2,3,1,2,8
2193,특강,1,2,4,1,8
2523,회사원,1,4,2,1,8
2516,태국,1,1,5,1,8
1469,개헌,4,2,1,1,8
2350,제보자,1,5,1,1,8
2476,토론,1,2,3,2,8
2447,지문,1,1,3,3,8
2284,일침,1,3,1,3,8
2377,설득,1,1,4,2,8
1489,고공,4,2,1,1,8
2294,수치심,1,3,2,2,8
2426,시계,1,5,1,1,8
1282,영포,5,1,1,1,8
2307,평생,1,5,1,1,8
1517,대검,4,2,1,1,8
1205,다행,5,1,1,1,8
2251,이면,1,1,4,2,8
2250,재배,1,3,2,2,8
2243,청부,1,1,4,2,8
2480,공시생,1,4,1,2,8
2206,아시아,1,3,3,1,8
2236,바다로,1,2,3,2,8
2315,진심,1,3,2,2,8
1528,대행,4,2,1,1,8
2487,이어진,1,2,2,3,8
1435,권익위,4,1,2,1,8
2325,효율,1,2,2,3,8
2498,술값,1,3,2,2,8
2501,사용자,1,3,3,1,8
2334,갈수록,1,2,4,1,8
1401,고용부,4,2,1,1,8
1550,변기,4,1,2,1,8
1391,외제차,4,1,1,2,8
2209,세로,1,2,4,1,8
1860,위치,2,3,2,1,8
2545,극복,1,3,3,1,8
2172,주가,2,2,3,1,8
1725,파도,3,1,3,1,8
1720,마감,3,2,2,1,8
1709,지갑,3,2,2,1,8
1698,단서,3,1,2,2,8
1697,초등학생,3,2,2,1,8
2029,순천,2,1,3,2,8
1681,별거,3,2,2,1,8
2042,고기,2,2,3,1,8
2044,과연,2,1,2,3,8
1667,전락,3,2,2,1,8
1666,생태,3,1,3,1,8
1662,객실,3,3,1,1,8
1658,충남지사,3,2,2,1,8
2067,서명,2,3,2,1,8
2070,숨기,2,1,4,1,8
2093,상관,2,1,2,3,8
2094,존중,2,2,3,1,8
2097,눈치,2,1,4,1,8
2104,집주인,2,4,1,1,8
1627,보행,3,1,1,3,8
2110,폐렴,2,2,2,2,8
2116,조류,2,1,2,3,8
2171,조합원,2,2,3,1,8
1996,재발,2,4,1,1,8
2119,배당,2,3,2,1,8
1994,수뢰,2,2,1,3,8
1864,교내,2,2,2,2,8
1839,이익,2,1,1,4,8
1838,베란다,3,3,1,1,8
1887,간음,2,1,4,1,8
1836,적법,3,2,1,2,8
1834,점심,3,3,1,1,8
1906,무전,2,1,4,1,8
1913,구간,2,2,3,1,8
1915,고속버스,2,1,2,3,8
1919,자꾸,2,2,3,1,8
1920,정년,2,2,3,1,8
1922,인격,2,1,1,4,8
1923,생활비,2,2,1,3,8
1801,파행,3,2,1,2,8
1793,지위,3,1,3,1,8
1947,신속,2,4,1,1,8
1948,도지사,2,2,3,1,8
1955,아웃,2,4,1,1,8
1774,다수,3,1,3,1,8
1770,혈세,3,2,1,2,8
1969,강조,2,3,2,1,8
2117,시내,2,2,2,2,8
2007,세번,2,2,3,1,8
2166,좌절,2,3,2,1,8
2148,조준,2,1,4,1,8
1592,철저,4,2,1,1,8
1581,배치,4,2,1,1,8
1604,각종,3,2,1,2,8
2132,푸드,2,1,4,1,8
2152,심층,2,3,1,2,8
2167,살이,2,1,4,1,8
2189,토사,1,2,2,2,7
2429,리나,1,2,3,1,7
2156,금감원,2,1,3,1,7
2039,모자,2,2,2,1,7
1682,사직서,3,1,2,1,7
1950,총파업,2,1,3,1,7
1951,기여,2,2,1,2,7
2045,세월,2,2,2,1,7
2423,억원,1,1,3,2,7
2034,하차,2,1,1,3,7
1943,민폐,2,1,2,2,7
2203,하자,1,2,3,1,7
2032,절단,2,2,2,1,7
1937,반격,2,1,2,2,7
2462,참작,1,4,1,1,7
2296,무조건,1,2,3,1,7
2458,잔혹,1,1,3,2,7
1460,사후,4,1,1,1,7
1928,수령,2,2,2,1,7
1802,악마,3,2,1,1,7
2452,재개발,1,2,3,1,7
2451,주먹,1,2,2,2,7
2157,입사,2,1,1,3,7
1661,법조,3,1,2,1,7
1933,나눔,2,1,3,1,7
2210,만기,1,3,1,2,7
2441,복용,1,1,2,3,7
2440,헌금,1,1,2,3,7
2438,학종,1,3,2,1,7
2208,심경,1,2,3,1,7
2338,인증샷,1,3,2,1,7
2141,손해,2,1,2,2,7
2028,대학병원,2,3,1,1,7
2374,대국민,1,2,2,2,7
2372,외교관,1,1,3,2,7
2370,태양광,1,1,2,3,7
1998,해운대,2,2,1,2,7
2001,개교,2,1,2,2,7
2380,가나,1,2,3,1,7
2381,양보,1,2,2,2,7
2364,신종,1,4,1,1,7
2363,원아,1,3,1,2,7
1609,준수,3,1,2,1,7
2385,구비,1,2,2,2,7
2386,신용,1,4,1,1,7
1749,온실가스,3,1,1,2,7
1754,조율,3,1,2,1,7
1986,교권,2,3,1,1,7
2395,탄생,1,2,3,1,7
1715,빈곤,3,2,1,1,7
2401,막무가내,1,1,4,1,7
2403,농약,1,1,1,4,7
1975,약사,2,3,1,1,7
2406,출입문,1,3,2,1,7
2348,중재,1,2,3,1,7
2020,체감,2,2,2,1,7
1554,주가조작,4,1,1,1,7
1967,금주,2,1,3,1,7
2409,눈앞,1,3,1,2,7
2147,협정,2,2,1,2,7
1924,화재현장,2,2,1,2,7
1808,남아,3,1,1,2,7
2378,화이트리스트,1,1,4,1,7
1914,삭발,2,2,1,2,7
1573,개막,4,1,1,1,7
2088,고함,2,2,2,1,7
1902,절벽,2,1,2,2,7
1636,발끈,3,2,1,1,7
2092,피고,2,3,1,1,7
2239,윤석열,1,1,2,3,7
1833,또래,3,1,1,2,7
2133,참가자,2,1,3,1,7
2500,일자,1,2,2,2,7
1844,집착,2,3,1,1,7
2465,도살,1,1,3,2,7
2518,역시,1,3,2,1,7
2257,지기,1,1,2,3,7
2096,실험,2,1,2,2,7
1888,언어,2,2,2,1,7
2100,멧돼지,2,2,2,1,7
1629,비만,3,1,2,1,7
2510,여가부,1,3,2,1,7
2249,기장,1,2,2,2,7
2113,총선,2,2,2,1,7
2109,손녀,2,2,2,1,7
2276,인척,1,1,2,3,7
2129,신문,2,1,2,2,7
2469,동두천,1,1,4,1,7
2162,신한은행,2,1,2,2,7
2163,해지,2,1,1,3,7
1865,장병,2,3,1,1,7
1918,대포통장,2,2,2,1,7
1642,강경,3,1,1,2,7
2282,도민,1,1,3,2,7
2281,성년,1,1,3,2,7
2081,조사해,2,3,1,1,7
1840,지능,2,1,2,2,7
1870,인수,2,2,1,2,7
2478,해산,1,3,2,1,7
2479,태안,1,4,1,1,7
2533,국립공원,1,2,3,1,7
1882,실시간,2,2,1,1,6
2175,홀인원,2,1,1,2,6
2383,이념,1,1,3,1,6
2524,이용자,1,2,2,1,6
2543,생존권,1,1,3,1,6
1841,용품,2,2,1,1,6
1867,이낙연,2,2,1,1,6
2379,성황리,1,2,2,1,6
1759,남원,3,1,1,1,6
1874,냉장고,2,1,2,1,6
1755,수립,3,1,1,1,6
2526,관리자,1,2,2,1,6
2541,이내,1,2,1,2,6
1845,분산,2,2,1,1,6
1876,서초구,2,1,1,2,6
1880,워크숍,2,1,1,2,6
2158,동성애,2,1,2,1,6
2177,표정,2,1,1,2,6
1942,프랑스,2,2,1,1,6
2459,애견,1,1,3,1,6
1995,원전,2,1,1,2,6
2456,안성,1,2,1,2,6
2455,명분,1,2,2,1,6
2475,외고,1,2,1,2,6
1916,수제,2,1,1,2,6
1935,동아,2,1,2,1,6
1936,국가대표,2,2,1,1,6
2481,불가능,1,1,3,1,6
2439,통학버스,1,1,3,1,6
1938,정신병,2,2,1,1,6
1911,가세,2,2,1,1,6
1963,악의,2,1,2,1,6
1910,가입자,2,1,2,1,6
1829,산업혁명,3,1,1,1,6
2492,인연,1,2,2,1,6
2493,국면,1,1,3,1,6
1895,아이돌,2,1,2,1,6
2421,전과자,1,1,3,1,6
2192,설사,1,1,3,1,6
2416,개조,1,2,2,1,6
2502,국민대,1,3,1,1,6
1890,중년,2,1,2,1,6
1957,신념,2,2,1,1,6
1956,가위,2,2,1,1,6
1606,교제,3,1,1,1,6
2309,애완견,1,1,3,1,6
2312,칼부림,1,1,2,2,6
2322,졸업,1,1,2,2,6
2218,층간소음,1,1,1,3,6
1647,심정지,3,1,1,1,6
2217,몸싸움,1,3,1,1,6
2246,부러,1,3,1,1,6
2342,염려,1,2,2,1,6
2248,이야기,1,2,2,1,6
2283,불명예,1,2,1,2,6
2056,근본,2,2,1,1,6
1637,바닷가,3,1,1,1,6
2352,퍼포먼스,1,1,1,3,6
2258,대포,1,1,3,1,6
1689,고령화,3,1,1,1,6
2095,브랜드,2,2,1,1,6
2262,배우자,1,2,2,1,6
2084,동상,2,1,2,1,6
2214,자신감,1,2,2,1,6
2326,차림,1,1,2,2,6
2089,강도짓,2,1,2,1,6
1598,안장,3,1,1,1,6
2108,총기,2,1,2,1,6
2207,부문,1,1,2,2,6
2299,실력,1,1,2,2,6
2062,상징,2,1,2,1,6
2064,융합,2,1,2,1,6
2360,불똥,1,1,1,3,6
2068,자도,2,1,1,2,6
2300,초래,1,2,2,1,6
2222,일행,1,1,1,3,6
2199,관측,1,3,1,1,6
2301,안녕하십니까,1,1,2,2,6
2221,육박,1,2,2,1,6
2121,수집,2,2,1,1,6
2123,금연,2,2,1,1,6
2115,면죄부,2,2,1,1,6
1727,블록,3,1,1,1,6
2353,은퇴,1,3,1,1,6
2131,전학,2,2,1,1,6
2225,연차,1,2,2,1,6
2182,스크린,1,2,1,1,5
2274,무제,1,1,2,1,5
1907,한국판,2,1,1,1,5
2470,방출,1,2,1,1,5
2183,소독,1,1,1,2,5
2468,김치,1,2,1,1,5
2280,경찰차,1,1,1,2,5
2213,사의,1,2,1,1,5
2161,기원,2,1,1,1,5
2078,외벽,2,1,1,1,5
2467,검정,1,2,1,1,5
2288,감봉,1,1,1,2,5
2196,호화,1,1,1,2,5
2259,예능,1,1,1,2,5
2090,카지노,2,1,1,1,5
2242,친정,1,1,1,2,5
1857,창의,2,1,1,1,5
1868,항변,2,1,1,1,5
2536,심해,1,1,2,1,5
2535,관람,1,2,1,1,5
2231,무색,1,2,1,1,5
2531,묘연,1,1,2,1,5
2529,절감,1,2,1,1,5
2528,홍수,1,1,2,1,5
2525,사면,1,2,1,1,5
1871,연간,2,1,1,1,5
2237,실천,1,2,1,1,5
2107,민영,2,1,1,1,5
1881,마중,2,1,1,1,5
1899,유골,2,1,1,1,5
2245,미리,1,1,2,1,5
2103,발뺌,2,1,1,1,5
2509,존폐,1,1,1,2,5
2507,숭실,1,2,1,1,5
2505,평소,1,2,1,1,5
2254,창틀,1,1,2,1,5
2375,조속,1,1,1,2,5
2261,이웃집,1,2,1,1,5
1896,마케팅,2,1,1,1,5
2497,신중,1,1,2,1,5
2263,외모,1,1,2,1,5
2269,보유,1,1,1,2,5
2211,현상,1,1,2,1,5
2461,포상,1,2,1,1,5
1992,직후,2,1,1,1,5
2339,헌법재판소,1,1,2,1,5
2205,카메라,1,1,1,2,5
2200,옹벽,1,2,1,1,5
1952,안전성,2,1,1,1,5
2329,배신,1,1,1,2,5
2422,대감,1,2,1,1,5
2332,이직,1,1,2,1,5
2420,매입,1,1,2,1,5
2333,번지,1,2,1,1,5
2417,유럽,1,1,2,1,5
2295,차지,1,2,1,1,5
2415,방식,1,2,1,1,5
2393,교량,1,2,1,1,5
2430,자정,1,2,1,1,5
2153,의견서,2,1,1,1,5
2394,투성이,1,2,1,1,5
1964,개시,2,1,1,1,5
2356,스타벅스,1,1,2,1,5
2343,새끼,1,1,2,1,5
2010,전혀,2,1,1,1,5
2398,평등,1,2,1,1,5
2195,교재,1,1,2,1,5
2019,고도,2,1,1,1,5
2016,교육과정,2,1,1,1,5
2402,점령,1,1,2,1,5
1976,지망,2,1,1,1,5
2324,비중,1,1,2,1,5
1979,자초,2,1,1,1,5
2198,순찰,1,2,1,1,5
2306,장교,1,1,2,1,5
2305,커뮤니티,1,2,1,1,5
2308,김구,1,1,1,2,5
2446,쓴소리,1,1,2,1,5
2445,과열,1,1,2,1,5
2382,감히,1,2,1,1,5
2442,일해,1,1,1,2,5
2190,파타야,1,1,1,2,5
2365,마치,1,1,1,2,5
2313,타깃,1,1,2,1,5
2314,기독교,1,2,1,1,5
2058,한류,2,1,1,1,5
2361,수영,1,1,2,1,5
2050,공갈,2,1,1,1,5
2387,설비,1,1,1,2,5
2138,편법,2,1,1,1,5
1939,이륙,2,1,1,1,5
2302,독립운동,1,1,2,1,5
1990,체인,2,1,1,1,5
2297,무관용,1,1,1,2,5
2389,후송,1,2,1,1,5
2450,재수감,1,1,1,2,5
2371,오거돈,1,1,1,1,4
2534,답안,1,1,1,1,4
2233,레이저,1,1,1,1,4
2366,조장,1,1,1,1,4
2539,보조,1,1,1,1,4
2532,조항,1,1,1,1,4
2358,하나로,1,1,1,1,4
2530,천차만별,1,1,1,1,4
2460,향응,1,1,1,1,4
2238,노래,1,1,1,1,4
2318,싸가지,1,1,1,1,4
2289,구경,1,1,1,1,4
2471,탈북자,1,1,1,1,4
2444,승강기,1,1,1,1,4
2477,통진당,1,1,1,1,4
2278,미정,1,1,1,1,4
2277,큰일,1,1,1,1,4
2275,지열발전소,1,1,1,1,4
2316,연료,1,1,1,1,4
2181,유료,1,1,1,1,4
2490,손찌검,1,1,1,1,4
2349,함정,1,1,1,1,4
2266,딜레마,1,1,1,1,4
2425,내면,1,1,1,1,4
2496,급전,1,1,1,1,4
2506,교대,1,1,1,1,4
2252,명꼴,1,1,1,1,4
2341,도망,1,1,1,1,4
2247,수주,1,1,1,1,4
2408,도로교통법,1,1,1,1,4
2344,용납,1,1,1,1,4
2335,불황,1,1,1,1,4
